date,id,name,source,today_confirmed,today_deaths,today_hospitalised_patients_with_symptoms,today_intensive_care,today_new_confirmed,today_new_deaths,today_new_hospitalised_patients_with_symptoms,today_new_intensive_care,today_new_open_cases,today_new_recovered,today_new_total_hospitalised_patients,today_open_cases,today_recovered,today_total_hospitalised_patients,today_vs_yesterday_confirmed,today_vs_yesterday_deaths,today_vs_yesterday_hospitalised_patients_with_symptoms,today_vs_yesterday_intensive_care,today_vs_yesterday_open_cases,today_vs_yesterday_recovered,today_vs_yesterday_total_hospitalised_patients,yesterday_confirmed,yesterday_deaths,yesterday_hospitalised_patients_with_symptoms,yesterday_intensive_care,yesterday_open_cases,yesterday_recovered,yesterday_total_hospitalised_patients
2020-03-20,castilla-la_mancha,Castilla-La Mancha,John Hopkins University,1423,84,0,65,379,42,0,28,326.0,11.0,322,1301,38.0,635,0.3630268199233717,1.0,,0.7567567567567568,0.3343589743589743,0.40740740740740744,1.0287539936102235,1044,42,0,37,975,27.0,313
2020-03-20,navarra,Navarra,John Hopkins University,664,9,0,25,110,4,0,6,106.0,,50,654,1.0,222,0.1985559566787003,0.8,,0.3157894736842106,0.1934306569343065,,0.2906976744186047,554,5,0,19,548,1.0,172
2020-03-20,melilla,Melilla,John Hopkins University,25,0,0,1,1,0,0,0,1.0,,3,25,,8,0.04166666666666674,,,0.0,0.04166666666666674,,0.6000000000000001,24,0,0,1,24,,5
2020-03-20,canarias,Canarias,John Hopkins University,348,7,0,29,61,3,0,4,58.0,,24,332,9.0,139,0.21254355400696867,0.75,,0.15999999999999992,0.2116788321167884,,0.20869565217391295,287,4,0,25,274,9.0,115
2020-03-20,baleares,Baleares,John Hopkins University,246,4,0,14,43,2,0,4,40.0,1.0,12,231,11.0,60,0.21182266009852224,1.0,,0.3999999999999999,0.2094240837696335,0.10000000000000009,0.25,203,2,0,10,191,10.0,48
2020-03-20,murcia,Murcia,John Hopkins University,240,1,0,14,36,1,0,3,35.0,,14,238,1.0,61,0.17647058823529416,,,0.2727272727272727,0.17241379310344818,,0.2978723404255319,204,0,0,11,203,1.0,47
2020-03-20,cataluna,Cataluña,John Hopkins University,4203,122,0,271,933,29,0,96,859.0,45.0,687,3889,192.0,1681,0.28532110091743124,0.31182795698924726,,0.5485714285714285,0.28349834983498345,0.30612244897959173,0.6911468812877264,3270,93,0,175,3030,147.0,994
2020-03-20,c_valenciana,C. Valenciana,John Hopkins University,1363,50,0,129,258,17,0,28,236.0,5.0,170,1288,25.0,947,0.23348416289592766,0.5151515151515151,,0.27722772277227725,0.2243346007604563,0.25,0.21879021879021887,1105,33,0,101,1052,20.0,777
2020-03-20,asturias,Asturias,John Hopkins University,524,7,0,18,95,3,0,5,88.0,4.0,26,501,16.0,155,0.22144522144522139,0.75,,0.3846153846153846,0.21307506053268765,0.33333333333333326,0.20155038759689914,429,4,0,13,413,12.0,129
2020-03-20,galicia,Galicia,John Hopkins University,739,9,0,40,161,4,0,6,156.0,1.0,30,724,6.0,168,0.2785467128027681,0.8,,0.17647058823529416,0.27464788732394374,0.19999999999999996,0.21739130434782616,578,5,0,34,568,5.0,138
2020-03-20,madrid,Madrid,John Hopkins University,15722,804,0,767,2323,176,0,89,1791.0,356.0,1050,13376,1542.0,7388,0.17337114710052992,0.28025477707006363,,0.1312684365781711,0.15459646094087187,0.300168634064081,0.1656674029662355,13399,628,0,678,11585,1186.0,6338
2020-03-20,andalucia,Andalucía,John Hopkins University,1515,40,0,53,228,10,0,15,218.0,,104,1439,36.0,605,0.17715617715617715,0.33333333333333326,,0.39473684210526305,0.17854217854217858,,0.2075848303393213,1287,30,0,38,1221,36.0,501
2020-03-20,castilla_y_leon,Castilla y León,John Hopkins University,1466,55,0,96,319,12,0,21,290.0,17.0,153,1357,54.0,629,0.27811682650392333,0.2790697674418605,,0.28,0.2717900656044987,0.45945945945945943,0.3214285714285714,1147,43,0,75,1067,37.0,476
2020-03-20,ceuta,Ceuta,John Hopkins University,5,0,0,0,0,0,0,0,,,0,5,,0,0.0,,,,,,,5,0,0,0,5,,0
2020-03-20,aragon,Aragón,John Hopkins University,424,22,0,33,64,5,0,5,59.0,,65,402,,192,0.1777777777777778,0.2941176470588236,,0.1785714285714286,0.1720116618075802,,0.5118110236220472,360,17,0,28,343,,127
2020-03-20,pais_vasco,País Vasco,John Hopkins University,1725,85,0,71,260,14,0,18,102.0,144.0,104,1475,165.0,654,0.1774744027303754,0.19718309859154926,,0.3396226415094339,0.07428987618353977,6.857142857142857,0.1890909090909092,1465,71,0,53,1373,21.0,550
2020-03-20,la_rioja,La Rioja,John Hopkins University,564,15,0,17,67,8,0,2,54.0,5.0,6,531,18.0,128,0.13480885311871238,1.1428571428571428,,0.1333333333333333,0.1132075471698113,0.3846153846153846,0.049180327868852514,497,7,0,15,477,13.0,122
2020-03-20,extremadura,Extremadura,John Hopkins University,354,12,0,6,57,2,0,2,54.0,1.0,21,334,8.0,65,0.19191919191919182,0.19999999999999996,,0.5,0.19285714285714284,0.1428571428571428,0.4772727272727273,297,10,0,4,280,7.0,44
2020-03-20,cantabria,Cantabria,John Hopkins University,215,2,0,9,71,1,0,2,69.0,1.0,31,202,11.0,92,0.4930555555555556,1.0,,0.2857142857142858,0.518796992481203,0.10000000000000009,0.5081967213114753,144,1,0,7,133,10.0,61
2020-03-21,castilla-la_mancha,Castilla-La Mancha,John Hopkins University,1819,112,0,76,396,28,0,11,358.0,10.0,203,1659,48.0,838,0.27828531271960655,0.33333333333333326,,0.1692307692307693,0.275172943889316,0.26315789473684204,0.31968503937007875,1423,84,0,65,1301,38.0,635
2020-03-21,navarra,Navarra,John Hopkins University,794,14,0,30,130,5,0,5,122.0,3.0,66,776,4.0,288,0.19578313253012047,0.5555555555555556,,0.19999999999999996,0.18654434250764518,3.0,0.29729729729729737,664,9,0,25,654,1.0,222
2020-03-21,melilla,Melilla,John Hopkins University,25,0,0,1,0,0,0,0,,,4,25,,12,0.0,,,0.0,,,0.5,25,0,0,1,25,,8
2020-03-21,canarias,Canarias,John Hopkins University,414,9,0,32,66,2,0,3,64.0,,11,398,7.0,150,0.18965517241379315,0.2857142857142858,,0.10344827586206895,0.19161676646706582,,0.07913669064748197,348,7,0,29,334,7.0,139
2020-03-21,baleares,Baleares,John Hopkins University,331,4,0,14,85,0,0,0,79.0,6.0,19,310,17.0,79,0.3455284552845528,0.0,,0.0,0.34199134199134207,0.5454545454545454,0.31666666666666665,246,4,0,14,231,11.0,60
2020-03-21,murcia,Murcia,John Hopkins University,296,1,0,16,56,0,0,2,56.0,,17,294,1.0,78,0.2333333333333334,0.0,,0.1428571428571428,0.23529411764705888,,0.278688524590164,240,1,0,14,238,1.0,61
2020-03-21,cataluna,Cataluña,John Hopkins University,5046,143,0,290,843,21,0,19,767.0,55.0,236,4656,247.0,1917,0.2005710206995004,0.1721311475409837,,0.07011070110701101,0.19722293648752887,0.28645833333333326,0.1403926234384294,4203,122,0,271,3889,192.0,1681
2020-03-21,c_valenciana,C. Valenciana,John Hopkins University,1604,69,0,152,241,19,0,23,217.0,5.0,189,1505,30.0,1136,0.1768158473954513,0.3799999999999999,,0.17829457364341095,0.1684782608695652,0.19999999999999996,0.19957761351636738,1363,50,0,129,1288,25.0,947
2020-03-21,asturias,Asturias,John Hopkins University,569,12,0,22,45,5,0,4,36.0,4.0,25,537,20.0,180,0.08587786259541974,0.7142857142857142,,0.22222222222222232,0.0718562874251496,0.25,0.16129032258064524,524,7,0,18,501,16.0,155
2020-03-21,galicia,Galicia,John Hopkins University,915,12,0,50,176,3,0,10,163.0,10.0,59,887,16.0,227,0.23815967523680648,0.33333333333333326,,0.25,0.22513812154696122,1.6666666666666665,0.3511904761904763,739,9,0,40,724,6.0,168
2020-03-21,madrid,Madrid,John Hopkins University,17397,1021,0,834,1675,217,0,67,1101.0,357.0,1053,14477,1899.0,8441,0.10653860831955231,0.2699004975124377,,0.08735332464146017,0.0823116028708133,0.23151750972762652,0.142528424472117,15722,804,0,767,13376,1542.0,7388
2020-03-21,andalucia,Andalucía,John Hopkins University,1725,47,0,55,210,7,0,2,201.0,2.0,119,1640,38.0,724,0.13861386138613851,0.17500000000000004,,0.037735849056603765,0.13968033356497567,0.05555555555555558,0.1966942148760331,1515,40,0,53,1439,36.0,605
2020-03-21,castilla_y_leon,Castilla y León,John Hopkins University,1744,74,0,111,278,19,0,15,224.0,35.0,169,1581,89.0,798,0.18963165075034105,0.34545454545454546,,0.15625,0.16507000736919686,0.6481481481481481,0.2686804451510334,1466,55,0,96,1357,54.0,629
2020-03-21,ceuta,Ceuta,John Hopkins University,5,0,0,0,0,0,0,0,,,0,5,,0,0.0,,,,,,,5,0,0,0,5,,0
2020-03-21,aragon,Aragón,John Hopkins University,532,24,0,45,108,2,0,12,103.0,3.0,49,505,3.0,241,0.2547169811320755,0.09090909090909083,,0.36363636363636354,0.2562189054726369,,0.25520833333333326,424,22,0,33,402,,192
2020-03-21,pais_vasco,País Vasco,John Hopkins University,2097,97,0,81,372,12,0,10,309.0,51.0,334,1784,216.0,988,0.21565217391304348,0.14117647058823524,,0.14084507042253525,0.20949152542372884,0.3090909090909091,0.510703363914373,1725,85,0,71,1475,165.0,654
2020-03-21,la_rioja,La Rioja,John Hopkins University,654,18,0,17,90,3,0,0,87.0,,6,618,18.0,134,0.15957446808510634,0.19999999999999996,,0.0,0.16384180790960445,,0.046875,564,15,0,17,531,18.0,128
2020-03-21,extremadura,Extremadura,John Hopkins University,384,14,0,8,30,2,0,2,28.0,,22,362,8.0,87,0.0847457627118644,0.16666666666666674,,0.33333333333333326,0.08383233532934131,,0.33846153846153837,354,12,0,6,334,8.0,65
2020-03-21,cantabria,Cantabria,John Hopkins University,282,5,0,9,67,3,0,0,64.0,,24,266,11.0,116,0.31162790697674425,1.5,,0.0,0.3168316831683169,,0.26086956521739135,215,2,0,9,202,11.0,92
2020-03-22,castilla-la_mancha,Castilla-La Mancha,John Hopkins University,2078,145,0,142,259,33,0,66,223,3.0,709,1882,51.0,1547,0.14238592633315017,0.2946428571428572,,0.868421052631579,0.13441832429174205,0.0625,0.8460620525059666,1819,112,0,76,1659,48.0,838
2020-03-22,navarra,Navarra,John Hopkins University,886,24,0,40,92,10,0,10,79,3.0,51,855,7.0,339,0.11586901763224189,0.7142857142857142,,0.33333333333333326,0.10180412371134029,0.75,0.17708333333333326,794,14,0,30,776,4.0,288
2020-03-22,melilla,Melilla,John Hopkins University,28,0,0,1,3,0,0,0,3,,0,28,,12,0.1200000000000001,,,0.0,0.1200000000000001,,0.0,25,0,0,1,25,,12
2020-03-22,canarias,Canarias,John Hopkins University,481,11,0,32,67,2,0,0,65,,22,463,7.0,172,0.16183574879227058,0.22222222222222232,,0.0,0.16331658291457285,,0.14666666666666672,414,9,0,32,398,7.0,150
2020-03-22,baleares,Baleares,John Hopkins University,400,10,0,27,69,6,0,13,62,1.0,8,372,18.0,87,0.2084592145015105,1.5,,0.9285714285714286,0.19999999999999996,0.05882352941176472,0.10126582278481022,331,4,0,14,310,17.0,79
2020-03-22,murcia,Murcia,John Hopkins University,345,2,0,23,49,1,0,7,48,,2,342,1.0,80,0.16554054054054057,1.0,,0.4375,0.16326530612244894,,0.02564102564102555,296,1,0,16,294,1.0,78
2020-03-22,cataluna,Cataluña,John Hopkins University,5747,199,0,308,701,56,0,18,490,155.0,241,5146,402.0,2158,0.13892191835116918,0.39160839160839167,,0.06206896551724128,0.10524054982817876,0.6275303643724697,0.12571726656233695,5046,143,0,290,4656,247.0,1917
2020-03-22,c_valenciana,C. Valenciana,John Hopkins University,1901,94,0,181,297,25,0,29,266,6.0,175,1771,36.0,1311,0.1851620947630923,0.3623188405797102,,0.19078947368421062,0.17674418604651154,0.19999999999999996,0.154049295774648,1604,69,0,152,1505,30.0,1136
2020-03-22,asturias,Asturias,John Hopkins University,621,22,0,25,52,10,0,3,41,1.0,30,578,21.0,210,0.0913884007029877,0.8333333333333333,,0.13636363636363646,0.07635009310986973,0.050000000000000044,0.16666666666666674,569,12,0,22,537,20.0,180
2020-03-22,galicia,Galicia,John Hopkins University,1208,18,0,62,293,6,0,12,284,3.0,43,1171,19.0,270,0.32021857923497277,0.5,,0.24,0.32018038331454335,0.1875,0.18942731277533031,915,12,0,50,887,16.0,227
2020-03-22,madrid,Madrid,John Hopkins University,18900,1263,0,942,1503,242,0,108,1097,164.0,1120,15574,2063.0,9561,0.08639420589756863,0.23702252693437798,,0.12949640287769792,0.07577536782482563,0.08636124275934698,0.1326857007463571,17397,1021,0,834,14477,1899.0,8441
2020-03-22,andalucia,Andalucía,John Hopkins University,1961,58,0,77,236,11,0,22,213,12.0,141,1853,50.0,865,0.13681159420289846,0.23404255319148937,,0.3999999999999999,0.1298780487804878,0.3157894736842106,0.19475138121546953,1725,47,0,55,1640,38.0,724
2020-03-22,castilla_y_leon,Castilla y León,John Hopkins University,2055,102,0,130,311,28,0,19,255,28.0,179,1836,117.0,977,0.17832568807339455,0.3783783783783783,,0.1711711711711712,0.16129032258064524,0.3146067415730338,0.2243107769423558,1744,74,0,111,1581,89.0,798
2020-03-22,ceuta,Ceuta,John Hopkins University,6,0,0,0,1,0,0,0,1,,0,6,,0,0.19999999999999996,,,,0.19999999999999996,,,5,0,0,0,5,,0
2020-03-22,aragon,Aragón,John Hopkins University,638,32,0,52,106,8,0,7,71,27.0,57,576,30.0,298,0.1992481203007519,0.33333333333333326,,0.15555555555555545,0.1405940594059405,9.0,0.2365145228215768,532,24,0,45,505,3.0,241
2020-03-22,pais_vasco,País Vasco,John Hopkins University,2421,120,0,92,324,23,0,11,234,67.0,264,2018,283.0,1252,0.15450643776824036,0.23711340206185572,,0.1358024691358024,0.1311659192825112,0.3101851851851851,0.2672064777327936,2097,97,0,81,1784,216.0,988
2020-03-22,la_rioja,La Rioja,John Hopkins University,747,22,0,22,93,4,0,5,89,,32,707,18.0,166,0.14220183486238525,0.22222222222222232,,0.2941176470588236,0.14401294498381878,,0.23880597014925375,654,18,0,17,618,18.0,134
2020-03-22,extremadura,Extremadura,John Hopkins University,493,18,0,13,109,4,0,5,105,,44,467,8.0,131,0.28385416666666674,0.2857142857142858,,0.625,0.2900552486187846,,0.5057471264367817,384,14,0,8,362,8.0,87
2020-03-22,cantabria,Cantabria,John Hopkins University,347,6,0,14,65,1,0,5,64,,41,330,11.0,157,0.23049645390070927,0.19999999999999996,,0.5555555555555556,0.24060150375939848,,0.35344827586206895,282,5,0,9,266,11.0,116
2020-03-23,castilla-la_mancha,Castilla-La Mancha,John Hopkins University,2465,216,0,182,387,71,0,40,314.0,2.0,279,2196,53.0,1826,0.1862367661212705,0.4896551724137932,,0.2816901408450705,0.16684378320935167,0.03921568627450989,0.1803490627020039,2078,145,0,142,1882,51.0,1547
2020-03-23,navarra,Navarra,John Hopkins University,1014,31,0,45,128,7,0,5,117.0,4.0,66,972,11.0,405,0.14446952595936802,0.29166666666666674,,0.125,0.13684210526315788,0.5714285714285714,0.19469026548672574,886,24,0,40,855,7.0,339
2020-03-23,melilla,Melilla,John Hopkins University,28,0,0,1,0,0,0,0,,,0,28,,12,0.0,,,0.0,,,0.0,28,0,0,1,28,,12
2020-03-23,canarias,Canarias,John Hopkins University,557,16,0,36,76,5,0,4,70.0,1.0,35,533,8.0,207,0.158004158004158,0.4545454545454546,,0.125,0.1511879049676026,0.1428571428571428,0.20348837209302317,481,11,0,32,463,7.0,172
2020-03-23,baleares,Baleares,John Hopkins University,478,10,0,35,78,0,0,8,77.0,1.0,40,449,19.0,127,0.19500000000000006,0.0,,0.2962962962962963,0.206989247311828,0.05555555555555558,0.45977011494252884,400,10,0,27,372,18.0,87
2020-03-23,murcia,Murcia,John Hopkins University,385,3,0,26,40,1,0,3,39.0,,19,381,1.0,99,0.11594202898550732,0.5,,0.13043478260869557,0.11403508771929816,,0.23750000000000004,345,2,0,23,342,1.0,80
2020-03-23,cataluna,Cataluña,John Hopkins University,7864,293,0,471,2117,94,0,163,1794.0,229.0,1051,6940,631.0,3209,0.36836610405428916,0.4723618090452262,,0.5292207792207793,0.348620287602021,0.5696517412935322,0.4870250231696014,5747,199,0,308,5146,402.0,2158
2020-03-23,c_valenciana,C. Valenciana,John Hopkins University,2167,115,0,222,266,21,0,41,244.0,1.0,251,2015,37.0,1562,0.13992635455023672,0.22340425531914887,,0.22651933701657456,0.13777526821005082,0.02777777777777768,0.19145690312738362,1901,94,0,181,1771,36.0,1311
2020-03-23,asturias,Asturias,John Hopkins University,754,26,0,29,133,4,0,4,120.0,9.0,41,698,30.0,251,0.21417069243156206,0.18181818181818188,,0.15999999999999992,0.20761245674740492,0.4285714285714286,0.1952380952380952,621,22,0,25,578,21.0,210
2020-03-23,galicia,Galicia,John Hopkins University,1415,20,0,78,207,2,0,16,205.0,,68,1376,19.0,338,0.17135761589403975,0.11111111111111116,,0.25806451612903225,0.17506404782237395,,0.25185185185185177,1208,18,0,62,1171,19.0,270
2020-03-23,madrid,Madrid,John Hopkins University,21569,1535,0,1050,2669,272,0,108,2169.0,228.0,882,17743,2291.0,10443,0.14121693121693113,0.21536025336500386,,0.1146496815286624,0.1392705791704123,0.11051866214251094,0.09224976466896773,18900,1263,0,942,15574,2063.0,9561
2020-03-23,andalucia,Andalucía,John Hopkins University,2470,87,0,102,509,29,0,25,464.0,16.0,267,2317,66.0,1132,0.2595614482406936,0.5,,0.3246753246753247,0.25040474905558563,0.32000000000000006,0.3086705202312139,1961,58,0,77,1853,50.0,865
2020-03-23,castilla_y_leon,Castilla y León,John Hopkins University,2460,124,0,151,405,22,0,21,360.0,23.0,220,2196,140.0,1197,0.197080291970803,0.21568627450980382,,0.16153846153846163,0.196078431372549,0.19658119658119655,0.22517911975435,2055,102,0,130,1836,117.0,977
2020-03-23,ceuta,Ceuta,John Hopkins University,6,0,0,0,0,0,0,0,,,0,6,,0,0.0,,,,,,,6,0,0,0,6,,0
2020-03-23,aragon,Aragón,John Hopkins University,758,37,0,66,120,5,0,14,115.0,,86,691,30.0,384,0.18808777429467094,0.15625,,0.26923076923076916,0.19965277777777768,,0.28859060402684555,638,32,0,52,576,30.0,298
2020-03-23,pais_vasco,País Vasco,John Hopkins University,2728,133,0,106,307,13,0,14,233.0,61.0,173,2251,344.0,1425,0.12680710450227184,0.10833333333333339,,0.15217391304347827,0.11546085232903858,0.215547703180212,0.13817891373801916,2421,120,0,92,2018,283.0,1252
2020-03-23,la_rioja,La Rioja,John Hopkins University,802,30,0,24,55,8,0,2,41.0,6.0,40,748,24.0,206,0.07362784471218209,0.36363636363636354,,0.09090909090909083,0.057991513437057884,0.33333333333333326,0.24096385542168686,747,22,0,22,707,18.0,166
2020-03-23,extremadura,Extremadura,John Hopkins University,636,26,0,20,143,8,0,7,133.0,2.0,30,602,8.0,161,0.2900608519269776,0.4444444444444444,,0.5384615384615385,0.28358208955223874,0.33333333333333326,0.2290076335877862,493,18,0,13,469,6.0,131
2020-03-23,cantabria,Cantabria,John Hopkins University,425,9,0,16,78,3,0,2,74.0,1.0,43,404,12.0,200,0.2247838616714697,0.5,,0.1428571428571428,0.22424242424242413,0.09090909090909083,0.2738853503184713,347,6,0,14,330,11.0,157
2020-03-24,castilla-la_mancha,Castilla-La Mancha,John Hopkins University,2780,263,0,210,315,47,0,28,250,18.0,336,2446,71.0,2162,0.12778904665314395,0.21759259259259256,,0.15384615384615374,0.11384335154826952,0.3396226415094339,0.18400876232201524,2465,216,0,182,2196,53.0,1826
2020-03-24,navarra,Navarra,John Hopkins University,1197,33,0,51,183,2,0,6,169,12.0,101,1141,23.0,506,0.180473372781065,0.06451612903225801,,0.1333333333333333,0.1738683127572016,1.0909090909090908,0.24938271604938267,1014,31,0,45,972,11.0,405
2020-03-24,melilla,Melilla,John Hopkins University,38,0,0,2,10,0,0,1,10,,2,38,,14,0.3571428571428572,,,1.0,0.3571428571428572,,0.16666666666666674,28,0,0,1,28,,12
2020-03-24,canarias,Canarias,John Hopkins University,657,21,0,43,100,5,0,7,88,7.0,28,621,15.0,235,0.17953321364452424,0.3125,,0.19444444444444442,0.1651031894934334,0.875,0.13526570048309172,557,16,0,36,533,8.0,207
2020-03-24,baleares,Baleares,John Hopkins University,562,13,0,40,84,3,0,5,72,9.0,37,521,28.0,164,0.17573221757322166,0.30000000000000004,,0.1428571428571428,0.16035634743875282,0.4736842105263157,0.2913385826771653,478,10,0,35,449,19.0,127
2020-03-24,murcia,Murcia,John Hopkins University,477,5,0,33,92,2,0,7,87,3.0,28,468,4.0,127,0.23896103896103904,0.6666666666666667,,0.26923076923076916,0.22834645669291342,3.0,0.2828282828282829,385,3,0,26,381,1.0,99
2020-03-24,cataluna,Cataluña,John Hopkins University,9937,385,0,713,2073,92,0,242,1651,330.0,1140,8591,961.0,4349,0.26360630722278744,0.31399317406143346,,0.5138004246284502,0.23789625360230549,0.5229793977812995,0.35525085696478653,7864,293,0,471,6940,631.0,3209
2020-03-24,c_valenciana,C. Valenciana,John Hopkins University,2616,143,0,255,449,28,0,33,414,7.0,280,2429,44.0,1842,0.20719889247808032,0.24347826086956514,,0.14864864864864868,0.20545905707196033,0.18918918918918926,0.1792573623559539,2167,115,0,222,2015,37.0,1562
2020-03-24,asturias,Asturias,John Hopkins University,812,29,0,39,58,3,0,10,50,5.0,30,748,35.0,281,0.07692307692307687,0.11538461538461542,,0.3448275862068966,0.07163323782234965,0.16666666666666674,0.1195219123505975,754,26,0,29,698,30.0,251
2020-03-24,galicia,Galicia,John Hopkins University,1653,27,0,100,238,7,0,22,225,6.0,74,1601,25.0,412,0.1681978798586572,0.3500000000000001,,0.28205128205128216,0.16351744186046502,0.3157894736842106,0.21893491124260356,1415,20,0,78,1376,19.0,338
2020-03-24,madrid,Madrid,John Hopkins University,24475,1825,0,1150,2906,290,0,100,1876,740.0,710,19619,3031.0,11153,0.1347304001112708,0.18892508143322484,,0.09523809523809534,0.1057318379079073,0.3230030554343082,0.06798812601742799,21569,1535,0,1050,17743,2291.0,10443
2020-03-24,andalucia,Andalucía,John Hopkins University,3008,113,0,116,538,26,0,14,507,5.0,301,2824,71.0,1433,0.21781376518218631,0.29885057471264376,,0.13725490196078427,0.21881743634009498,0.07575757575757569,0.26590106007067127,2470,87,0,102,2317,66.0,1132
2020-03-24,castilla_y_leon,Castilla y León,John Hopkins University,2940,165,0,179,480,41,0,28,366,73.0,260,2562,213.0,1457,0.19512195121951215,0.3306451612903225,,0.185430463576159,0.16666666666666674,0.5214285714285714,0.2172096908939014,2460,124,0,151,2196,140.0,1197
2020-03-24,ceuta,Ceuta,John Hopkins University,9,0,0,1,3,0,0,1,3,,2,9,,2,0.5,,,,0.5,,,6,0,0,0,6,,0
2020-03-24,aragon,Aragón,John Hopkins University,907,40,0,75,149,3,0,9,145,1.0,75,863,4.0,459,0.19656992084432723,0.08108108108108114,,0.13636363636363646,0.20194986072423404,0.33333333333333326,0.1953125,758,37,0,66,718,3.0,384
2020-03-24,pais_vasco,País Vasco,John Hopkins University,3271,155,0,119,543,22,0,13,399,122.0,152,2650,466.0,1577,0.1990469208211143,0.16541353383458657,,0.12264150943396235,0.17725455353176356,0.35465116279069764,0.10666666666666669,2728,133,0,106,2251,344.0,1425
2020-03-24,la_rioja,La Rioja,John Hopkins University,928,37,0,33,126,7,0,9,100,19.0,48,848,43.0,254,0.1571072319201996,0.2333333333333334,,0.375,0.1336898395721926,0.7916666666666667,0.23300970873786397,802,30,0,24,748,24.0,206
2020-03-24,extremadura,Extremadura,John Hopkins University,742,39,0,28,106,13,0,8,93,,48,695,8.0,209,0.16666666666666674,0.5,,0.3999999999999999,0.154485049833887,,0.2981366459627328,636,26,0,20,602,8.0,161
2020-03-24,cantabria,Cantabria,John Hopkins University,510,14,0,18,85,5,0,2,80,,41,484,12.0,241,0.19999999999999996,0.5555555555555556,,0.125,0.19801980198019797,,0.20500000000000007,425,9,0,16,404,12.0,200
2020-03-25,castilla-la_mancha,Castilla-La Mancha,John Hopkins University,3383,316,0,243,603,53,0,33,526.0,24.0,0,2972,95.0,2162,0.2169064748201439,0.20152091254752857,,0.15714285714285725,0.21504497138184786,0.3380281690140845,0.0,2780,263,0,210,2446,71.0,2162
2020-03-25,navarra,Navarra,John Hopkins University,1411,49,0,54,214,16,0,3,186.0,12.0,143,1327,35.0,649,0.17878028404344204,0.48484848484848486,,0.05882352941176472,0.16301489921121814,0.5217391304347827,0.28260869565217384,1197,33,0,51,1141,23.0,506
2020-03-25,melilla,Melilla,John Hopkins University,39,1,0,2,1,1,0,0,,,2,38,,16,0.026315789473684292,,,0.0,,,0.1428571428571428,38,0,0,2,38,,14
2020-03-25,canarias,Canarias,John Hopkins University,784,24,0,45,127,3,0,2,121.0,3.0,44,742,18.0,279,0.19330289193302885,0.1428571428571428,,0.04651162790697683,0.19484702093397743,0.19999999999999996,0.18723404255319154,657,21,0,43,621,15.0,235
2020-03-25,baleares,Baleares,John Hopkins University,660,17,0,43,98,4,0,3,83.0,11.0,41,604,39.0,205,0.17437722419928825,0.3076923076923077,,0.07499999999999996,0.15930902111324374,0.3928571428571428,0.25,562,13,0,40,521,28.0,164
2020-03-25,murcia,Murcia,John Hopkins University,596,8,0,36,119,3,0,3,111.0,5.0,45,579,9.0,172,0.24947589098532497,0.6000000000000001,,0.09090909090909083,0.23717948717948723,1.25,0.35433070866141736,477,5,0,33,468,4.0,127
2020-03-25,cataluna,Cataluña,John Hopkins University,11592,501,0,764,1655,116,0,51,1492.0,47.0,1022,10083,1008.0,5371,0.16654926034014284,0.3012987012987014,,0.07152875175315576,0.17367011989291115,0.048907388137356955,0.2349965509312486,9937,385,0,713,8591,961.0,4349
2020-03-25,c_valenciana,C. Valenciana,John Hopkins University,3200,167,0,289,584,24,0,34,547.0,13.0,255,2976,57.0,2097,0.2232415902140672,0.16783216783216792,,0.1333333333333333,0.225195553725813,0.2954545454545454,0.13843648208469062,2616,143,0,255,2429,44.0,1842
2020-03-25,asturias,Asturias,John Hopkins University,891,29,0,48,79,0,0,9,74.0,5.0,41,822,40.0,322,0.09729064039408875,0.0,,0.23076923076923084,0.09893048128342241,0.1428571428571428,0.14590747330960863,812,29,0,39,748,35.0,281
2020-03-25,galicia,Galicia,John Hopkins University,1915,32,0,107,262,5,0,7,235.0,22.0,91,1836,47.0,503,0.1584996975196613,0.18518518518518512,,0.07000000000000006,0.14678326046221102,0.8799999999999999,0.220873786407767,1653,27,0,100,1601,25.0,412
2020-03-25,madrid,Madrid,John Hopkins University,27422,2090,0,1221,2947,265,0,71,1831.0,851.0,1287,21450,3882.0,12440,0.12040858018386102,0.14520547945205475,,0.06173913043478252,0.09332789642693307,0.2807654239524908,0.11539496099704105,24475,1825,0,1150,19619,3031.0,11153
2020-03-25,andalucia,Andalucía,John Hopkins University,3404,134,0,134,396,21,0,18,369.0,6.0,193,3193,77.0,1626,0.13164893617021267,0.18584070796460184,,0.15517241379310343,0.1306657223796035,0.08450704225352124,0.13468248429867402,3008,113,0,116,2824,71.0,1433
2020-03-25,castilla_y_leon,Castilla y León,John Hopkins University,3488,206,0,198,548,41,0,19,412.0,95.0,366,2974,308.0,1823,0.1863945578231292,0.24848484848484853,,0.1061452513966481,0.16081186572989847,0.4460093896713615,0.2512010981468771,2940,165,0,179,2562,213.0,1457
2020-03-25,ceuta,Ceuta,John Hopkins University,10,0,0,2,1,0,0,1,1.0,,0,10,,2,0.11111111111111116,,,1.0,0.11111111111111116,,0.0,9,0,0,1,9,,2
2020-03-25,aragon,Aragón,John Hopkins University,1116,48,0,93,209,8,0,18,201.0,,103,1064,4.0,562,0.23042998897464173,0.19999999999999996,,0.24,0.23290845886442635,,0.224400871459695,907,40,0,75,863,4.0,459
2020-03-25,pais_vasco,País Vasco,John Hopkins University,3946,180,0,137,675,25,0,18,495.0,155.0,330,3145,621.0,1907,0.20635891164781417,0.16129032258064524,,0.15126050420168058,0.18679245283018875,0.3326180257510729,0.2092580849714647,3271,155,0,119,2650,466.0,1577
2020-03-25,la_rioja,La Rioja,John Hopkins University,995,43,0,36,67,6,0,3,56.0,5.0,62,904,48.0,316,0.07219827586206895,0.16216216216216206,,0.09090909090909083,0.0660377358490567,0.11627906976744184,0.2440944881889764,928,37,0,33,848,43.0,254
2020-03-25,extremadura,Extremadura,John Hopkins University,969,58,0,34,227,19,0,6,192.0,16.0,32,887,24.0,241,0.30592991913746626,0.4871794871794872,,0.2142857142857142,0.2762589928057555,2.0,0.15311004784688986,742,39,0,28,695,8.0,209
2020-03-25,cantabria,Cantabria,John Hopkins University,671,17,0,26,161,3,0,8,156.0,2.0,59,640,14.0,300,0.3156862745098039,0.2142857142857142,,0.4444444444444444,0.3223140495867769,0.16666666666666674,0.24481327800829877,510,14,0,18,484,12.0,241
2020-03-26,castilla-la_mancha,Castilla-La Mancha,John Hopkins University,3934,367,0,273,551,51,0,30,442,58.0,545,3414,153.0,2707,0.16287318947679585,0.1613924050632911,,0.1234567901234569,0.148721399730821,0.6105263157894736,0.25208140610545793,3383,316,0,243,2972,95.0,2162
2020-03-26,navarra,Navarra,John Hopkins University,1641,58,0,75,230,9,0,21,186,35.0,83,1513,70.0,732,0.16300496102055284,0.18367346938775508,,0.38888888888888884,0.14016578749058017,1.0,0.12788906009244982,1411,49,0,54,1327,35.0,649
2020-03-26,melilla,Melilla,John Hopkins University,42,1,0,2,3,0,0,0,3,,2,41,,18,0.07692307692307687,0.0,,0.0,0.07894736842105265,,0.125,39,1,0,2,38,,16
2020-03-26,canarias,Canarias,John Hopkins University,878,27,0,61,94,3,0,16,89,2.0,49,831,20.0,328,0.11989795918367352,0.125,,0.3555555555555556,0.11994609164420478,0.11111111111111116,0.17562724014336917,784,24,0,45,742,18.0,279
2020-03-26,baleares,Baleares,John Hopkins University,755,22,0,46,95,5,0,3,62,28.0,32,666,67.0,237,0.14393939393939403,0.2941176470588236,,0.06976744186046502,0.10264900662251653,0.7179487179487178,0.15609756097560967,660,17,0,43,604,39.0,205
2020-03-26,murcia,Murcia,John Hopkins University,714,15,0,53,118,7,0,17,108,3.0,37,687,12.0,209,0.19798657718120816,0.875,,0.4722222222222223,0.18652849740932642,0.33333333333333326,0.21511627906976738,596,8,0,36,579,9.0,172
2020-03-26,cataluna,Cataluña,John Hopkins University,12940,685,0,972,1348,184,0,208,690,474.0,1343,10773,1482.0,6714,0.11628709454796415,0.3672654690618762,,0.2722513089005236,0.06843201428146384,0.47023809523809534,0.2500465462669894,11592,501,0,764,10083,1008.0,5371
2020-03-26,c_valenciana,C. Valenciana,John Hopkins University,3532,198,0,325,332,31,0,36,285,16.0,260,3261,73.0,2357,0.10375000000000001,0.18562874251497008,,0.12456747404844282,0.09576612903225801,0.2807017543859649,0.1239866475917979,3200,167,0,289,2976,57.0,2097
2020-03-26,asturias,Asturias,John Hopkins University,960,39,0,56,69,10,0,8,47,12.0,48,869,52.0,370,0.07744107744107742,0.3448275862068966,,0.16666666666666674,0.05717761557177625,0.30000000000000004,0.14906832298136652,891,29,0,48,822,40.0,322
2020-03-26,galicia,Galicia,John Hopkins University,2322,43,0,122,407,11,0,15,376,20.0,54,2212,67.0,557,0.21253263707571812,0.34375,,0.14018691588785037,0.20479302832244017,0.42553191489361697,0.10735586481113324,1915,32,0,107,1836,47.0,503
2020-03-26,madrid,Madrid,John Hopkins University,30796,2412,0,1312,3374,322,0,91,1890,1162.0,1140,23340,5044.0,13580,0.1230398949748377,0.1540669856459329,,0.07452907452907453,0.08811188811188808,0.2993302421432251,0.09163987138263674,27422,2090,0,1221,21450,3882.0,12440
2020-03-26,andalucia,Andalucía,John Hopkins University,3790,144,0,148,386,10,0,14,361,15.0,217,3554,92.0,1843,0.1133960047003526,0.07462686567164178,,0.10447761194029859,0.11305981835264634,0.19480519480519476,0.1334563345633457,3404,134,0,134,3193,77.0,1626
2020-03-26,castilla_y_leon,Castilla y León,John Hopkins University,4132,252,0,215,644,46,0,17,483,115.0,391,3457,423.0,2214,0.18463302752293576,0.2233009708737863,,0.08585858585858586,0.16240753194351032,0.37337662337662336,0.21448162369720247,3488,206,0,198,2974,308.0,1823
2020-03-26,ceuta,Ceuta,John Hopkins University,17,0,0,2,7,0,0,0,7,,0,17,,2,0.7,,,0.0,0.7,,0.0,10,0,0,2,10,,2
2020-03-26,aragon,Aragón,John Hopkins University,1338,58,0,114,222,10,0,21,208,4.0,131,1272,8.0,693,0.19892473118279574,0.20833333333333326,,0.22580645161290325,0.19548872180451138,1.0,0.23309608540925275,1116,48,0,93,1064,4.0,562
2020-03-26,pais_vasco,País Vasco,John Hopkins University,4601,207,0,154,655,27,0,17,435,193.0,363,3580,814.0,2270,0.1659908768373035,0.1499999999999999,,0.12408759124087587,0.13831478537360886,0.31078904991948475,0.1903513371788148,3946,180,0,137,3145,621.0,1907
2020-03-26,la_rioja,La Rioja,John Hopkins University,1236,55,0,43,241,12,0,7,215,14.0,72,1119,62.0,388,0.24221105527638187,0.2790697674418605,,0.19444444444444442,0.23783185840707954,0.29166666666666674,0.2278481012658229,995,43,0,36,904,48.0,316
2020-03-26,extremadura,Extremadura,John Hopkins University,1231,69,0,41,262,11,0,7,242,9.0,36,1129,33.0,277,0.2703818369453044,0.18965517241379315,,0.2058823529411764,0.27282976324689967,0.375,0.14937759336099576,969,58,0,34,887,24.0,241
2020-03-26,cantabria,Cantabria,John Hopkins University,810,21,0,29,139,4,0,3,130,5.0,55,770,19.0,355,0.20715350223546936,0.23529411764705888,,0.11538461538461542,0.203125,0.3571428571428572,0.18333333333333335,671,17,0,26,640,14.0,300
2020-03-27,castilla-la_mancha,Castilla-La Mancha,John Hopkins University,4512,448,0,289,578,81,0,16,453,44.0,270,3867,197.0,2977,0.1469242501270971,0.22070844686648505,,0.05860805860805862,0.13268892794376108,0.2875816993464053,0.09974141115626156,3934,367,0,273,3414,153.0,2707
2020-03-27,navarra,Navarra,John Hopkins University,1829,70,0,84,188,12,0,9,148,28.0,95,1661,98.0,827,0.11456429006703228,0.2068965517241379,,0.1200000000000001,0.09781890284203576,0.3999999999999999,0.1297814207650274,1641,58,0,75,1513,70.0,732
2020-03-27,melilla,Melilla,John Hopkins University,45,1,0,2,3,0,0,0,3,,4,44,,22,0.0714285714285714,0.0,,0.0,0.07317073170731714,,0.22222222222222232,42,1,0,2,41,,18
2020-03-27,canarias,Canarias,John Hopkins University,1025,36,0,68,147,9,0,7,133,5.0,49,964,25.0,377,0.16742596810933952,0.33333333333333326,,0.11475409836065564,0.16004813477737656,0.25,0.14939024390243905,878,27,0,61,831,20.0,328
2020-03-27,baleares,Baleares,John Hopkins University,862,26,0,59,107,4,0,13,90,13.0,46,756,80.0,283,0.14172185430463569,0.18181818181818188,,0.28260869565217384,0.1351351351351351,0.19402985074626855,0.19409282700421948,755,22,0,46,666,67.0,237
2020-03-27,murcia,Murcia,John Hopkins University,802,17,0,58,88,2,0,5,86,,22,773,12.0,231,0.12324929971988796,0.1333333333333333,,0.09433962264150941,0.12518195050946135,,0.10526315789473695,714,15,0,53,687,12.0,209
2020-03-27,cataluna,Cataluña,John Hopkins University,14263,827,0,1036,1323,142,0,64,946,235.0,1240,11719,1717.0,7954,0.10224111282843884,0.20729927007299276,,0.06584362139917688,0.0878121228998423,0.15856950067476383,0.18468871015787913,12940,685,0,972,10773,1482.0,6714
2020-03-27,c_valenciana,C. Valenciana,John Hopkins University,4034,234,0,348,502,36,0,23,447,19.0,249,3708,92.0,2606,0.14212910532276335,0.18181818181818188,,0.0707692307692307,0.13707451701931928,0.26027397260273966,0.10564276622825619,3532,198,0,325,3261,73.0,2357
2020-03-27,asturias,Asturias,John Hopkins University,1037,44,0,59,77,5,0,3,59,13.0,57,928,65.0,427,0.08020833333333344,0.1282051282051282,,0.0535714285714286,0.06789413118527032,0.25,0.15405405405405403,960,39,0,56,869,52.0,370
2020-03-27,galicia,Galicia,John Hopkins University,2772,47,0,141,450,4,0,19,418,28.0,349,2630,95.0,906,0.193798449612403,0.09302325581395343,,0.15573770491803285,0.18896925858951175,0.4179104477611941,0.6265709156193895,2322,43,0,122,2212,67.0,557
2020-03-27,madrid,Madrid,John Hopkins University,33162,2757,0,1404,2366,345,0,92,739,1282.0,631,24079,6326.0,14211,0.0768281595012339,0.14303482587064686,,0.07012195121951215,0.03166238217652095,0.2541633624107851,0.046465390279823326,30796,2412,0,1312,23340,5044.0,13580
2020-03-27,andalucia,Andalucía,John Hopkins University,4271,175,0,172,481,31,0,24,403,47.0,263,3957,139.0,2106,0.12691292875989446,0.21527777777777768,,0.16216216216216206,0.11339335959482266,0.5108695652173914,0.14270211611502992,3790,144,0,148,3554,92.0,1843
2020-03-27,castilla_y_leon,Castilla y León,John Hopkins University,4791,321,0,238,659,69,0,23,428,162.0,434,3885,585.0,2648,0.15948693126815106,0.2738095238095237,,0.10697674418604652,0.12380676887474684,0.38297872340425543,0.1960252935862692,4132,252,0,215,3457,423.0,2214
2020-03-27,ceuta,Ceuta,John Hopkins University,17,1,0,2,0,1,0,0,-1,,0,16,,2,0.0,,,0.0,-0.05882352941176472,,0.0,17,0,0,2,17,,2
2020-03-27,aragon,Aragón,John Hopkins University,1592,93,0,124,254,35,0,10,219,,142,1491,8.0,835,0.18983557548579966,0.603448275862069,,0.08771929824561409,0.17216981132075482,,0.20490620490620493,1338,58,0,114,1272,8.0,693
2020-03-27,pais_vasco,País Vasco,John Hopkins University,5136,241,0,176,535,34,0,22,292,209.0,342,3872,1023.0,2612,0.11627906976744184,0.16425120772946866,,0.1428571428571428,0.08156424581005584,0.2567567567567568,0.15066079295154178,4601,207,0,154,3580,814.0,2270
2020-03-27,la_rioja,La Rioja,John Hopkins University,1436,65,0,43,200,10,0,0,-112,302.0,70,1007,364.0,458,0.1618122977346279,0.18181818181818188,,0.0,-0.1000893655049151,4.870967741935484,0.18041237113402064,1236,55,0,43,1119,62.0,388
2020-03-27,extremadura,Extremadura,John Hopkins University,1394,88,0,40,163,19,0,-1,128,16.0,35,1257,49.0,312,0.132412672623883,0.2753623188405796,,-0.024390243902439046,0.11337466784765282,0.48484848484848486,0.12635379061371843,1231,69,0,41,1129,33.0,277
2020-03-27,cantabria,Cantabria,John Hopkins University,937,22,0,37,127,1,0,8,124,2.0,51,894,21.0,406,0.1567901234567901,0.04761904761904767,,0.27586206896551735,0.1610389610389611,0.10526315789473695,0.14366197183098595,810,21,0,29,770,19.0,355
2020-03-28,castilla-la_mancha,Castilla-La Mancha,John Hopkins University,5246,539,0,299,734,91,0,10,604,39.0,41,4471,236.0,3018,0.16267730496453892,0.203125,,0.03460207612456756,0.15619343160072408,0.19796954314720816,0.013772253946926494,4512,448,0,289,3867,197.0,2977
2020-03-28,navarra,Navarra,John Hopkins University,2011,84,0,90,182,14,0,6,141,27.0,69,1802,125.0,896,0.09950792782941509,0.19999999999999996,,0.0714285714285714,0.08488862131246244,0.2755102040816326,0.08343409915356714,1829,70,0,84,1661,98.0,827
2020-03-28,melilla,Melilla,John Hopkins University,48,1,0,2,3,0,0,0,3,,2,47,,24,0.06666666666666665,0.0,,0.0,0.06818181818181812,,0.09090909090909083,45,1,0,2,44,,22
2020-03-28,canarias,Canarias,John Hopkins University,1125,39,0,78,100,3,0,10,92,5.0,48,1056,30.0,425,0.09756097560975618,0.08333333333333326,,0.1470588235294117,0.09543568464730301,0.19999999999999996,0.1273209549071619,1025,36,0,68,964,25.0,377
2020-03-28,baleares,Baleares,John Hopkins University,958,29,0,71,96,3,0,12,91,2.0,62,847,82.0,345,0.11136890951276102,0.11538461538461542,,0.20338983050847448,0.12037037037037046,0.02499999999999991,0.21908127208480566,862,26,0,59,756,80.0,283
2020-03-28,murcia,Murcia,John Hopkins University,872,20,0,58,70,3,0,0,63,4.0,29,836,16.0,260,0.08728179551122195,0.17647058823529416,,0.0,0.08150064683053038,0.33333333333333326,0.12554112554112562,802,17,0,58,773,12.0,231
2020-03-28,cataluna,Cataluña,John Hopkins University,15025,904,0,1080,762,77,0,44,436,249.0,493,12155,1966.0,8447,0.05342494566360512,0.09310761789600974,,0.042471042471042386,0.03720453963648773,0.1450203843913802,0.06198139300980632,14263,827,0,1036,11719,1717.0,7954
2020-03-28,c_valenciana,C. Valenciana,John Hopkins University,4784,267,0,375,750,33,0,27,648,69.0,167,4356,161.0,2773,0.18591968269707482,0.14102564102564097,,0.07758620689655182,0.17475728155339798,0.75,0.0640828856485034,4034,234,0,348,3708,92.0,2606
2020-03-28,asturias,Asturias,John Hopkins University,1143,47,0,63,106,3,0,4,92,11.0,25,1020,76.0,452,0.10221793635486986,0.06818181818181812,,0.06779661016949157,0.09913793103448265,0.1692307692307693,0.058548009367681564,1037,44,0,59,928,65.0,427
2020-03-28,galicia,Galicia,John Hopkins University,3139,60,0,159,367,13,0,18,296,58.0,137,2926,153.0,1043,0.1323953823953823,0.27659574468085113,,0.12765957446808507,0.11254752851711025,0.6105263157894736,0.15121412803532008,2772,47,0,141,2630,95.0,906
2020-03-28,madrid,Madrid,John Hopkins University,34189,3082,0,1429,1027,325,0,25,-463,1165.0,243,23616,7491.0,14454,0.030969181593390127,0.1178817555313747,,0.017806267806267817,-0.019228373271315213,0.18416060701865322,0.017099430018999273,33162,2757,0,1404,24079,6326.0,14211
2020-03-28,andalucia,Andalucía,John Hopkins University,4676,207,0,201,405,32,0,29,364,9.0,188,4321,148.0,2294,0.09482556778272078,0.18285714285714283,,0.16860465116279078,0.09198888046499865,0.06474820143884896,0.0892687559354226,4271,175,0,172,3957,139.0,2106
2020-03-28,castilla_y_leon,Castilla y León,John Hopkins University,5414,380,0,261,623,59,0,23,397,167.0,512,4282,752.0,3160,0.13003548319766223,0.1838006230529594,,0.09663865546218497,0.10218790218790219,0.28547008547008557,0.19335347432024164,4791,321,0,238,3885,585.0,2648
2020-03-28,ceuta,Ceuta,John Hopkins University,21,1,0,2,4,0,0,0,4,,0,20,,2,0.23529411764705888,0.0,,0.0,0.25,,0.0,17,1,0,2,16,,2
2020-03-28,aragon,Aragón,John Hopkins University,1858,104,0,124,266,11,0,0,255,,0,1746,8.0,835,0.1670854271356783,0.11827956989247301,,0.0,0.1710261569416498,,0.0,1592,93,0,124,1491,8.0,835
2020-03-28,pais_vasco,País Vasco,John Hopkins University,5740,265,0,271,604,24,0,95,100,480.0,494,3972,1503.0,3106,0.11760124610591904,0.09958506224066399,,0.5397727272727273,0.025826446280991844,0.46920821114369504,0.1891271056661561,5136,241,0,176,3872,1023.0,2612
2020-03-28,la_rioja,La Rioja,John Hopkins University,1629,68,0,43,193,3,0,0,157,33.0,39,1164,397.0,497,0.1344011142061281,0.04615384615384621,,0.0,0.15590863952333667,0.09065934065934056,0.08515283842794763,1436,65,0,43,1007,364.0,458
2020-03-28,extremadura,Extremadura,John Hopkins University,1456,100,0,41,62,12,0,1,48,2.0,1,1305,51.0,313,0.0444763271162123,0.13636363636363646,,0.02499999999999991,0.038186157517899666,0.04081632653061229,0.0032051282051281937,1394,88,0,40,1257,49.0,312
2020-03-28,cantabria,Cantabria,John Hopkins University,1023,26,0,40,86,4,0,3,79,3.0,43,973,24.0,449,0.09178228388473864,0.18181818181818188,,0.08108108108108114,0.0883668903803132,0.1428571428571428,0.10591133004926112,937,22,0,37,894,21.0,406
2020-03-29,castilla-la_mancha,Castilla-La Mancha,John Hopkins University,5858,622,0,302,612,83,0,3,513,16.0,116,4984,252.0,3134,0.11666031261913834,0.15398886827458247,,0.010033444816053505,0.11473943189443081,0.06779661016949157,0.038436050364479835,5246,539,0,299,4471,236.0,3018
2020-03-29,navarra,Navarra,John Hopkins University,2146,102,0,96,135,18,0,6,81,36.0,59,1883,161.0,955,0.06713078070611633,0.2142857142857142,,0.06666666666666665,0.044950055493895746,0.28800000000000003,0.06584821428571419,2011,84,0,90,1802,125.0,896
2020-03-29,melilla,Melilla,John Hopkins University,51,1,0,3,3,0,0,1,3,,3,50,,27,0.0625,0.0,,0.5,0.06382978723404253,,0.125,48,1,0,2,47,,24
2020-03-29,canarias,Canarias,John Hopkins University,1204,40,0,84,79,1,0,6,76,2.0,19,1132,32.0,444,0.07022222222222219,0.02564102564102555,,0.07692307692307687,0.07196969696969702,0.06666666666666665,0.04470588235294115,1125,39,0,78,1056,30.0,425
2020-03-29,baleares,Baleares,John Hopkins University,1000,37,0,80,42,8,0,9,16,18.0,8,863,100.0,353,0.04384133611691032,0.27586206896551735,,0.12676056338028174,0.018890200708382432,0.2195121951219512,0.023188405797101463,958,29,0,71,847,82.0,345
2020-03-29,murcia,Murcia,John Hopkins University,939,25,0,58,67,5,0,0,61,1.0,5,897,17.0,265,0.076834862385321,0.25,,0.0,0.07296650717703357,0.0625,0.019230769230769162,872,20,0,58,836,16.0,260
2020-03-29,cataluna,Cataluña,John Hopkins University,16104,983,0,1150,1079,79,0,70,798,202.0,679,12953,2168.0,9126,0.07181364392678868,0.08738938053097356,,0.06481481481481488,0.06565199506375974,0.10274669379450652,0.08038356813069725,15025,904,0,1080,12155,1966.0,8447
2020-03-29,c_valenciana,C. Valenciana,John Hopkins University,5110,310,0,393,326,43,0,18,259,24.0,141,4615,185.0,2914,0.06814381270903014,0.16104868913857673,,0.04800000000000004,0.059458218549127695,0.14906832298136652,0.05084745762711873,4784,267,0,375,4356,161.0,2773
2020-03-29,asturias,Asturias,John Hopkins University,1206,59,0,67,63,12,0,4,49,2.0,39,1069,78.0,491,0.055118110236220375,0.25531914893617014,,0.06349206349206349,0.04803921568627456,0.026315789473684292,0.08628318584070804,1143,47,0,63,1020,76.0,452
2020-03-29,galicia,Galicia,John Hopkins University,3723,66,0,176,584,6,0,17,563,15.0,104,3489,168.0,1147,0.18604651162790709,0.10000000000000009,,0.10691823899371067,0.19241285030758726,0.0980392156862746,0.09971236816874396,3139,60,0,159,2926,153.0,1043
2020-03-29,madrid,Madrid,John Hopkins University,35061,3392,0,1460,872,310,0,31,-248,810.0,463,23368,8301.0,14917,0.025505279475854792,0.10058403634003898,,0.021693491952414323,-0.010501355013550095,0.10812975570684813,0.03203265532032651,34189,3082,0,1429,23616,7491.0,14454
2020-03-29,andalucia,Andalucía,John Hopkins University,5398,236,0,216,722,29,0,15,686,7.0,377,5007,155.0,2671,0.1544054747647563,0.14009661835748788,,0.07462686567164178,0.15875954640129608,0.04729729729729737,0.16434176111595455,4676,207,0,201,4321,148.0,2294
2020-03-29,castilla_y_leon,Castilla y León,John Hopkins University,5801,442,0,272,387,62,0,11,206,119.0,251,4488,871.0,3411,0.07148134466198752,0.16315789473684217,,0.04214559386973171,0.04810836057916856,0.1582446808510638,0.07943037974683542,5414,380,0,261,4282,752.0,3160
2020-03-29,ceuta,Ceuta,John Hopkins University,25,1,0,2,4,0,0,0,4,,0,24,,2,0.19047619047619047,0.0,,0.0,0.19999999999999996,,0.0,21,1,0,2,20,,2
2020-03-29,aragon,Aragón,John Hopkins University,2078,106,0,156,220,2,0,32,52,166.0,259,1798,174.0,1094,0.11840688912809472,0.019230769230769162,,0.25806451612903225,0.02978235967926679,20.75,0.31017964071856285,1858,104,0,124,1746,8.0,835
2020-03-29,pais_vasco,País Vasco,John Hopkins University,6057,297,0,293,317,32,0,22,142,143.0,321,4114,1646.0,3427,0.055226480836236824,0.12075471698113205,,0.08118081180811809,0.03575025176233626,0.0951430472388557,0.1033483580167418,5740,265,0,271,3972,1503.0,3106
2020-03-29,la_rioja,La Rioja,John Hopkins University,1733,71,0,43,104,3,0,0,67,34.0,20,1231,431.0,517,0.06384284837323517,0.044117647058823595,,0.0,0.05756013745704469,0.08564231738035266,0.04024144869215296,1629,68,0,43,1164,397.0,497
2020-03-29,extremadura,Extremadura,John Hopkins University,1560,106,0,43,104,6,0,2,89,9.0,40,1394,60.0,353,0.0714285714285714,0.06000000000000005,,0.04878048780487809,0.06819923371647518,0.17647058823529416,0.12779552715654963,1456,100,0,41,1305,51.0,313
2020-03-29,cantabria,Cantabria,John Hopkins University,1100,27,0,46,77,1,0,6,76,,32,1049,24.0,481,0.07526881720430101,0.03846153846153855,,0.1499999999999999,0.07810894141829383,,0.07126948775055686,1023,26,0,40,973,24.0,449
2020-03-30,castilla-la_mancha,Castilla-La Mancha,John Hopkins University,6424,708,0,344,566,86,0,42,436,44.0,91,5420,296.0,3225,0.09662000682826899,0.13826366559485526,,0.13907284768211925,0.08747993579454261,0.17460317460317465,0.029036375239310797,5858,622,0,302,4984,252.0,3134
2020-03-30,navarra,Navarra,John Hopkins University,2305,113,0,99,159,11,0,3,117,31.0,80,2000,192.0,1035,0.07409133271202228,0.10784313725490202,,0.03125,0.06213489113117365,0.1925465838509317,0.08376963350785349,2146,102,0,96,1883,161.0,955
2020-03-30,melilla,Melilla,John Hopkins University,54,1,0,3,3,0,0,0,3,,0,53,,27,0.05882352941176472,0.0,,0.0,0.06000000000000005,,0.0,51,1,0,3,50,,27
2020-03-30,canarias,Canarias,John Hopkins University,1262,55,0,94,58,15,0,10,18,25.0,39,1150,57.0,483,0.04817275747508298,0.375,,0.11904761904761907,0.01590106007067127,0.78125,0.08783783783783794,1204,40,0,84,1132,32.0,444
2020-03-30,baleares,Baleares,John Hopkins University,1069,42,0,85,69,5,0,5,53,11.0,46,916,111.0,399,0.06899999999999995,0.1351351351351351,,0.0625,0.06141367323290847,0.1100000000000001,0.13031161473087827,1000,37,0,80,863,100.0,353
2020-03-30,murcia,Murcia,John Hopkins University,974,34,0,59,35,9,0,1,23,3.0,18,920,20.0,283,0.03727369542066028,0.3600000000000001,,0.01724137931034475,0.02564102564102555,0.17647058823529416,0.06792452830188678,939,25,0,58,897,17.0,265
2020-03-30,cataluna,Cataluña,John Hopkins University,18520,1216,0,1218,2416,233,0,68,1718,465.0,799,14671,2633.0,9925,0.15002483854942872,0.23702950152594093,,0.05913043478260871,0.13263336678761672,0.2144833948339484,0.08755204909051062,16104,983,0,1150,12953,2168.0,9126
2020-03-30,c_valenciana,C. Valenciana,John Hopkins University,5508,339,0,416,398,29,0,23,354,15.0,197,4969,200.0,3111,0.07788649706457917,0.09354838709677415,,0.058524173027989734,0.07670639219935005,0.08108108108108114,0.06760466712422786,5110,310,0,393,4615,185.0,2914
2020-03-30,asturias,Asturias,John Hopkins University,1295,66,0,71,89,7,0,4,70,12.0,38,1139,90.0,529,0.07379767827529027,0.11864406779661008,,0.05970149253731338,0.06548175865294659,0.15384615384615374,0.07739307535641538,1206,59,0,67,1069,78.0,491
2020-03-30,galicia,Galicia,John Hopkins University,4039,84,0,189,316,18,0,13,279,19.0,103,3768,187.0,1250,0.08487778673113078,0.2727272727272727,,0.07386363636363646,0.07996560619088555,0.11309523809523814,0.08979947689625112,3723,66,0,176,3489,168.0,1147
2020-03-30,madrid,Madrid,John Hopkins University,37607,3603,0,1514,2546,211,0,54,1306,1029.0,223,24674,9330.0,15140,0.07261629731040187,0.06220518867924518,,0.03698630136986303,0.05588839438548443,0.12396096855800498,0.01494938660588585,35061,3392,0,1460,23368,8301.0,14917
2020-03-30,andalucia,Andalucía,John Hopkins University,5809,248,0,235,411,12,0,19,394,5.0,196,5401,160.0,2867,0.07613931085587256,0.05084745762711873,,0.08796296296296302,0.07868983423207498,0.032258064516129004,0.07338075627105956,5398,236,0,216,5007,155.0,2671
2020-03-30,castilla_y_leon,Castilla y León,John Hopkins University,6211,516,0,294,410,74,0,22,179,157.0,218,4667,1028.0,3629,0.07067746940182729,0.16742081447963808,,0.0808823529411764,0.039884135472370685,0.1802525832376578,0.06391087657578431,5801,442,0,272,4488,871.0,3411
2020-03-30,ceuta,Ceuta,John Hopkins University,34,1,0,3,9,0,0,1,9,,1,33,,3,0.3600000000000001,0.0,,0.5,0.375,,0.5,25,1,0,2,24,,2
2020-03-30,aragon,Aragón,John Hopkins University,2272,138,0,165,194,32,0,9,132,30.0,82,1930,204.0,1176,0.09335899903753608,0.3018867924528301,,0.05769230769230771,0.07341490545050067,0.17241379310344818,0.07495429616087756,2078,106,0,156,1798,174.0,1094
2020-03-30,pais_vasco,País Vasco,John Hopkins University,6320,325,0,307,263,28,0,14,85,150.0,167,4199,1796.0,3594,0.04342083539706132,0.09427609427609429,,0.04778156996587035,0.02066115702479343,0.09113001215066818,0.04873066822293559,6057,297,0,293,4114,1646.0,3427
2020-03-30,la_rioja,La Rioja,John Hopkins University,1810,85,0,51,77,14,0,8,-2,65.0,58,1229,496.0,575,0.04443162146566637,0.19718309859154926,,0.18604651162790709,-0.0016246953696181787,0.15081206496519717,0.11218568665377182,1733,71,0,43,1231,431.0,517
2020-03-30,extremadura,Extremadura,John Hopkins University,1628,133,0,51,68,27,0,8,10,31.0,18,1404,91.0,371,0.04358974358974366,0.2547169811320755,,0.18604651162790709,0.007173601147776099,0.5166666666666666,0.05099150141643061,1560,106,0,43,1394,60.0,353
2020-03-30,cantabria,Cantabria,John Hopkins University,1171,37,0,50,71,10,0,4,50,11.0,41,1099,35.0,522,0.06454545454545446,0.37037037037037046,,0.08695652173913038,0.04766444232602485,0.45833333333333326,0.08523908523908519,1100,27,0,46,1049,24.0,481
2020-03-31,castilla-la_mancha,Castilla-La Mancha,John Hopkins University,7047,774,0,353,623,66,0,9,456,101.0,5,5876,397.0,3230,0.09698007471980086,0.09322033898305082,,0.026162790697674465,0.08413284132841325,0.34121621621621623,0.0015503875968991832,6424,708,0,344,5420,296.0,3225
2020-03-31,navarra,Navarra,John Hopkins University,2497,130,0,104,192,17,0,5,131,44.0,85,2131,236.0,1120,0.08329718004338393,0.1504424778761062,,0.05050505050505061,0.06549999999999989,0.22916666666666674,0.08212560386473422,2305,113,0,99,2000,192.0,1035
2020-03-31,melilla,Melilla,John Hopkins University,62,1,0,3,8,0,0,0,8,,5,61,,32,0.14814814814814814,0.0,,0.0,0.15094339622641506,,0.18518518518518512,54,1,0,3,53,,27
2020-03-31,canarias,Canarias,John Hopkins University,1380,62,0,110,118,7,0,16,91,20.0,49,1241,77.0,532,0.09350237717908083,0.1272727272727272,,0.17021276595744683,0.07913043478260873,0.3508771929824561,0.10144927536231885,1262,55,0,94,1150,57.0,483
2020-03-31,baleares,Baleares,John Hopkins University,1131,46,0,94,62,4,0,9,-1,59.0,68,915,170.0,467,0.05799812909260993,0.09523809523809534,,0.10588235294117654,-0.0010917030567685337,0.5315315315315314,0.17042606516290726,1069,42,0,85,916,111.0,399
2020-03-31,murcia,Murcia,John Hopkins University,1041,37,0,59,67,3,0,0,41,23.0,21,961,43.0,304,0.06878850102669398,0.08823529411764697,,0.0,0.04456521739130426,1.15,0.07420494699646651,974,34,0,59,920,20.0,283
2020-03-31,cataluna,Cataluña,John Hopkins University,19991,1458,0,1345,1471,242,0,127,785,444.0,1521,15456,3077.0,11446,0.07942764578833694,0.19901315789473695,,0.10426929392446627,0.05350691841046973,0.168628940372199,0.15324937027707808,18520,1216,0,1218,14671,2633.0,9925
2020-03-31,c_valenciana,C. Valenciana,John Hopkins University,5922,395,0,434,414,56,0,18,318,40.0,142,5287,240.0,3253,0.07516339869281041,0.16519174041297946,,0.04326923076923084,0.06399678003622467,0.19999999999999996,0.045644487303117875,5508,339,0,416,4969,200.0,3111
2020-03-31,asturias,Asturias,John Hopkins University,1367,75,0,79,72,9,0,8,44,19.0,25,1183,109.0,554,0.055598455598455665,0.13636363636363646,,0.11267605633802824,0.03863037752414389,0.21111111111111103,0.047258979206049156,1295,66,0,71,1139,90.0,529
2020-03-31,galicia,Galicia,John Hopkins University,4432,103,0,203,393,19,0,14,302,72.0,88,4070,259.0,1338,0.09730131220599159,0.22619047619047628,,0.07407407407407418,0.08014861995753719,0.3850267379679144,0.07040000000000002,4039,84,0,189,3768,187.0,1250
2020-03-31,madrid,Madrid,John Hopkins University,39409,3865,0,1514,1802,262,0,0,43,1497.0,87,24717,10827.0,15227,0.04791661126917868,0.07271718012767137,,0.0,0.001742725135770451,0.16045016077170415,0.005746367239101824,37607,3603,0,1514,24674,9330.0,15140
2020-03-31,andalucia,Andalucía,John Hopkins University,6379,308,0,260,570,60,0,25,488,22.0,280,5889,182.0,3147,0.09812360130831466,0.24193548387096775,,0.1063829787234043,0.0903536382151453,0.13749999999999996,0.09766306243460066,5809,248,0,235,5401,160.0,2867
2020-03-31,castilla_y_leon,Castilla y León,John Hopkins University,6847,585,0,318,636,69,0,24,336,231.0,322,5003,1259.0,3951,0.10239896957011752,0.13372093023255816,,0.08163265306122458,0.07199485751017787,0.22470817120622577,0.08872967759713424,6211,516,0,294,4667,1028.0,3629
2020-03-31,ceuta,Ceuta,John Hopkins University,51,1,0,3,17,0,0,0,17,,3,50,,6,0.5,0.0,,0.0,0.5151515151515151,,1.0,34,1,0,3,33,,3
2020-03-31,aragon,Aragón,John Hopkins University,2491,169,0,168,219,31,0,3,135,53.0,58,2065,257.0,1234,0.0963908450704225,0.2246376811594204,,0.018181818181818077,0.06994818652849744,0.2598039215686274,0.04931972789115657,2272,138,0,165,1930,204.0,1176
2020-03-31,pais_vasco,País Vasco,John Hopkins University,6838,369,0,324,518,44,0,17,105,369.0,212,4304,2165.0,3806,0.08196202531645569,0.13538461538461544,,0.055374592833876246,0.02500595379852344,0.2054565701559019,0.058987200890372904,6320,325,0,307,4199,1796.0,3594
2020-03-31,la_rioja,La Rioja,John Hopkins University,1960,90,0,54,150,5,0,3,72,73.0,44,1301,569.0,619,0.08287292817679548,0.05882352941176472,,0.05882352941176472,0.058584214808787616,0.14717741935483875,0.0765217391304347,1810,85,0,51,1229,496.0,575
2020-03-31,extremadura,Extremadura,John Hopkins University,1679,152,0,58,51,19,0,7,10,22.0,1,1414,113.0,372,0.03132678132678124,0.1428571428571428,,0.13725490196078427,0.007122507122507171,0.2417582417582418,0.0026954177897573484,1628,133,0,51,1404,91.0,371
2020-03-31,cantabria,Cantabria,John Hopkins University,1213,54,0,54,42,17,0,4,17,8.0,21,1116,43.0,543,0.035866780529461906,0.45945945945945943,,0.08000000000000007,0.015468607825295688,0.22857142857142865,0.04022988505747116,1171,37,0,50,1099,35.0,522
2020-04-01,castilla-la_mancha,Castilla-La Mancha,John Hopkins University,7682,854,0,355,635,80,0,2,458.0,97.0,0,6334,494.0,3230,0.09010926635447714,0.10335917312661502,,0.0056657223796034994,0.07794417971409118,0.24433249370277088,0.0,7047,774,0,353,5876,397.0,3230
2020-04-01,navarra,Navarra,John Hopkins University,2682,141,0,108,185,11,0,4,132.0,42.0,61,2263,278.0,1181,0.0740889066880257,0.08461538461538454,,0.03846153846153855,0.06194274988268411,0.17796610169491522,0.05446428571428563,2497,130,0,104,2131,236.0,1120
2020-04-01,melilla,Melilla,John Hopkins University,62,1,0,3,0,0,0,0,,,0,61,,32,0.0,0.0,,0.0,,,0.0,62,1,0,3,61,,32
2020-04-01,canarias,Canarias,John Hopkins University,1444,68,0,113,64,6,0,3,41.0,17.0,34,1282,94.0,566,0.04637681159420293,0.09677419354838701,,0.027272727272727337,0.03303787268331981,0.22077922077922074,0.06390977443609014,1380,62,0,110,1241,77.0,532
2020-04-01,baleares,Baleares,John Hopkins University,1204,58,0,104,73,12,0,10,-8.0,69.0,49,907,239.0,516,0.06454465075154725,0.26086956521739135,,0.1063829787234043,-0.008743169398907069,0.40588235294117636,0.10492505353319048,1131,46,0,94,915,170.0,467
2020-04-01,murcia,Murcia,John Hopkins University,1084,42,0,68,43,5,0,9,36.0,2.0,85,997,45.0,389,0.04130643611911622,0.1351351351351351,,0.15254237288135597,0.037460978147762836,0.04651162790697683,0.2796052631578947,1041,37,0,59,961,43.0,304
2020-04-01,cataluna,Cataluña,John Hopkins University,21804,1629,0,1415,1813,171,0,70,1036.0,606.0,952,16492,3683.0,12398,0.09069081086488917,0.11728395061728403,,0.052044609665427455,0.06702898550724634,0.19694507637309067,0.08317316092958249,19991,1458,0,1345,15456,3077.0,11446
2020-04-01,c_valenciana,C. Valenciana,John Hopkins University,6308,443,0,449,386,48,0,15,146.0,192.0,136,5433,432.0,3389,0.06518068220195872,0.12151898734177213,,0.034562211981566726,0.027614904482693436,0.8,0.04180756225023052,5922,395,0,434,5287,240.0,3253
2020-04-01,asturias,Asturias,John Hopkins University,1435,76,0,84,68,1,0,5,41.0,26.0,48,1224,135.0,602,0.049743964886612924,0.01333333333333342,,0.06329113924050622,0.03465765004226551,0.23853211009174302,0.08664259927797824,1367,75,0,79,1183,109.0,554
2020-04-01,galicia,Galicia,John Hopkins University,4842,120,0,212,410,17,0,9,319.0,74.0,109,4389,333.0,1447,0.0925090252707581,0.16504854368932032,,0.044334975369458185,0.07837837837837847,0.2857142857142858,0.08146487294469362,4432,103,0,203,4070,259.0,1338
2020-04-01,madrid,Madrid,John Hopkins University,41199,4175,0,1528,1790,310,0,14,-93.0,1573.0,0,24624,12400.0,15227,0.04542109670379868,0.08020698576972829,,0.009247027741083214,-0.003762592547639332,0.14528493580862656,0.0,39409,3865,0,1514,24717,10827.0,15227
2020-04-01,andalucia,Andalucía,John Hopkins University,6957,343,0,280,578,35,0,20,497.0,46.0,297,6386,228.0,3444,0.0906098134503841,0.11363636363636354,,0.07692307692307687,0.08439463406350822,0.25274725274725274,0.09437559580552901,6379,308,0,260,5889,182.0,3147
2020-04-01,castilla_y_leon,Castilla y León,John Hopkins University,7355,641,0,332,508,56,0,14,213.0,239.0,256,5216,1498.0,4207,0.07419307726011382,0.09572649572649583,,0.04402515723270439,0.04257445532680393,0.18983320095313738,0.06479372310807396,6847,585,0,318,5003,1259.0,3951
2020-04-01,ceuta,Ceuta,John Hopkins University,55,1,0,3,4,0,0,0,4.0,,1,54,,7,0.07843137254901955,0.0,,0.0,0.08000000000000007,,0.16666666666666674,51,1,0,3,50,,6
2020-04-01,aragon,Aragón,John Hopkins University,2700,200,0,178,209,31,0,10,115.0,63.0,86,2180,320.0,1320,0.08390204737053386,0.18343195266272194,,0.059523809523809534,0.0556900726392251,0.24513618677042803,0.06969205834683945,2491,169,0,168,2065,257.0,1234
2020-04-01,pais_vasco,País Vasco,John Hopkins University,7317,412,0,344,479,43,0,20,111.0,325.0,281,4415,2490.0,4087,0.07004972214097682,0.1165311653116532,,0.06172839506172845,0.0257899628252789,0.15011547344110854,0.07383079348397259,6838,369,0,324,4304,2165.0,3806
2020-04-01,la_rioja,La Rioja,John Hopkins University,2083,101,0,57,123,11,0,3,40.0,72.0,41,1341,641.0,660,0.06275510204081636,0.12222222222222223,,0.05555555555555558,0.030745580322828703,0.12653778558875217,0.06623586429725359,1960,90,0,54,1301,569.0,619
2020-04-01,extremadura,Extremadura,John Hopkins University,1837,181,0,62,158,29,0,4,103.0,26.0,40,1517,139.0,412,0.0941036331149494,0.19078947368421062,,0.06896551724137923,0.07284299858557275,0.23008849557522115,0.10752688172043001,1679,152,0,58,1414,113.0,372
2020-04-01,cantabria,Cantabria,John Hopkins University,1268,60,0,57,55,6,0,3,32.0,17.0,24,1148,60.0,567,0.045342126957955475,0.11111111111111116,,0.05555555555555558,0.028673835125448077,0.39534883720930236,0.04419889502762442,1213,54,0,54,1116,43.0,543
2020-04-02,castilla-la_mancha,Castilla-La Mancha,John Hopkins University,8523,916,0,355,841,62,0,0,694,85,-62,7028,579,3168,0.10947669877636024,0.07259953161592514,,0.0,0.10956741395642555,0.17206477732793513,-0.019195046439628438,7682,854,0,355,6334,494.0,3230
2020-04-02,navarra,Navarra,John Hopkins University,2836,151,0,119,154,10,0,11,128,16,103,2391,294,1284,0.05741983594332578,0.07092198581560294,,0.10185185185185186,0.05656208572691113,0.05755395683453246,0.0872142252328536,2682,141,0,108,2263,278.0,1181
2020-04-02,melilla,Melilla,John Hopkins University,70,2,0,3,8,1,0,0,3,4,2,64,4,34,0.12903225806451624,1.0,,0.0,0.049180327868852514,,0.0625,62,1,0,3,61,,32
2020-04-02,canarias,Canarias,John Hopkins University,1490,73,0,120,46,5,0,7,33,8,39,1315,102,605,0.03185595567867039,0.07352941176470584,,0.06194690265486735,0.025741029641185742,0.0851063829787233,0.06890459363957602,1444,68,0,113,1282,94.0,566
2020-04-02,baleares,Baleares,John Hopkins University,1257,69,0,111,53,11,0,7,-94,136,70,813,375,586,0.04401993355481726,0.18965517241379315,,0.06730769230769229,-0.10363836824696804,0.5690376569037656,0.1356589147286822,1204,58,0,104,907,239.0,516
2020-04-02,murcia,Murcia,John Hopkins University,1145,46,0,72,61,4,0,4,12,45,16,1009,90,405,0.05627306273062738,0.09523809523809534,,0.05882352941176472,0.012036108324974926,1.0,0.041131105398457546,1084,42,0,68,997,45.0,389
2020-04-02,cataluna,Cataluña,John Hopkins University,23460,1784,0,1482,1656,155,0,67,1308,193,703,17800,3876,13101,0.07594936708860756,0.09515039901780242,,0.047349823321554796,0.07931118117875324,0.05240293239207161,0.05670269398290051,21804,1629,0,1415,16492,3683.0,12398
2020-04-02,c_valenciana,C. Valenciana,John Hopkins University,6624,511,0,460,316,68,0,11,88,160,103,5521,592,3492,0.050095117311350634,0.15349887133182838,,0.024498886414253906,0.01619731271857172,0.37037037037037046,0.030392446149306585,6308,443,0,449,5433,432.0,3389
2020-04-02,asturias,Asturias,John Hopkins University,1504,80,0,88,69,4,0,4,46,19,32,1270,154,634,0.04808362369337971,0.05263157894736836,,0.04761904761904767,0.03758169934640532,0.14074074074074083,0.0531561461794019,1435,76,0,84,1224,135.0,602
2020-04-02,galicia,Galicia,John Hopkins University,5219,138,0,219,377,18,0,7,257,102,183,4646,435,1630,0.0778603882693103,0.1499999999999999,,0.03301886792452824,0.05855547960811114,0.3063063063063063,0.12646855563234283,4842,120,0,212,4389,333.0,1447
2020-04-02,madrid,Madrid,John Hopkins University,43038,4483,0,1506,1839,308,0,-22,81,1450,-177,24705,13850,15050,0.044637005752566905,0.07377245508982044,,-0.014397905759162333,0.00328947368421062,0.11693548387096775,-0.011624088789649933,41199,4175,0,1528,24624,12400.0,15227
2020-04-02,andalucia,Andalucía,John Hopkins University,7353,376,0,338,396,33,0,58,333,30,229,6719,258,3673,0.056921086675291166,0.09620991253644307,,0.20714285714285707,0.0521453178828688,0.13157894736842102,0.06649245063879206,6957,343,0,280,6386,228.0,3444
2020-04-02,castilla_y_leon,Castilla y León,John Hopkins University,7875,723,0,342,520,82,0,10,177,261,265,5393,1759,4472,0.07070020394289589,0.12792511700468023,,0.030120481927710774,0.033934049079754613,0.17423230974632853,0.06299025433800809,7355,641,0,332,5216,1498.0,4207
2020-04-02,ceuta,Ceuta,John Hopkins University,62,1,0,3,7,0,0,0,5,2,1,59,2,8,0.1272727272727272,0.0,,0.0,0.09259259259259256,,0.1428571428571428,55,1,0,3,54,,7
2020-04-02,aragon,Aragón,John Hopkins University,2889,224,0,180,189,24,0,2,107,58,111,2287,378,1431,0.07000000000000006,0.1200000000000001,,0.011235955056179803,0.04908256880733952,0.1812499999999999,0.084090909090909,2700,200,0,178,2180,320.0,1320
2020-04-02,pais_vasco,País Vasco,John Hopkins University,7827,444,0,363,510,32,0,19,159,319,196,4574,2809,4283,0.06970069700697001,0.07766990291262132,,0.05523255813953498,0.036013590033975085,0.12811244979919678,0.04795693662833367,7317,412,0,344,4415,2490.0,4087
2020-04-02,la_rioja,La Rioja,John Hopkins University,2224,109,0,64,141,8,0,7,29,104,78,1370,745,738,0.06769083053288516,0.07920792079207928,,0.12280701754385959,0.02162565249813575,0.16224648985959433,0.11818181818181817,2083,101,0,57,1341,641.0,660
2020-04-02,extremadura,Extremadura,John Hopkins University,1893,200,0,64,56,19,0,2,12,25,3,1529,164,415,0.03048448557430583,0.1049723756906078,,0.032258064516129004,0.007910349373764003,0.17985611510791366,0.00728155339805836,1837,181,0,62,1517,139.0,412
2020-04-02,cantabria,Cantabria,John Hopkins University,1321,64,0,59,53,4,0,2,35,14,25,1183,74,592,0.04179810725552047,0.06666666666666665,,0.03508771929824572,0.030487804878048808,0.2333333333333334,0.04409171075837737,1268,60,0,57,1148,60.0,567
2020-04-03,castilla-la_mancha,Castilla-La Mancha,John Hopkins University,9324,989,0,360,801,73,0,5,650,78.0,-35,7678,657,3133,0.09398099260823645,0.07969432314410474,,0.014084507042253502,0.09248719408081962,0.13471502590673579,-0.011047979797979779,8523,916,0,355,7028,579,3168
2020-04-03,navarra,Navarra,John Hopkins University,2972,171,0,120,136,20,0,1,99,17.0,57,2490,311,1341,0.04795486600846255,0.13245033112582782,,0.008403361344537785,0.04140526976160608,0.05782312925170063,0.04439252336448596,2836,151,0,119,2391,294,1284
2020-04-03,melilla,Melilla,John Hopkins University,79,2,0,3,9,0,0,0,4,5.0,3,68,9,37,0.12857142857142856,0.0,,0.0,0.0625,1.25,0.08823529411764697,70,2,0,3,64,4,34
2020-04-03,canarias,Canarias,John Hopkins University,1564,78,0,128,74,5,0,8,48,21.0,27,1363,123,632,0.04966442953020134,0.06849315068493156,,0.06666666666666665,0.03650190114068441,0.2058823529411764,0.044628099173553704,1490,73,0,120,1315,102,605
2020-04-03,baleares,Baleares,John Hopkins University,1271,71,0,113,14,2,0,2,-35,47.0,47,778,422,633,0.011137629276054106,0.02898550724637672,,0.018018018018018056,-0.043050430504305015,0.1253333333333333,0.08020477815699656,1257,69,0,111,813,375,586
2020-04-03,murcia,Murcia,John Hopkins University,1188,51,0,79,43,5,0,7,15,23.0,29,1024,113,434,0.03755458515283849,0.10869565217391308,,0.09722222222222232,0.014866204162537144,0.25555555555555554,0.07160493827160486,1145,46,0,72,1009,90,405
2020-04-03,cataluna,Cataluña,John Hopkins University,24734,1928,0,1569,1274,144,0,87,417,713.0,1150,18217,4589,14251,0.054305200341006055,0.08071748878923768,,0.05870445344129549,0.02342696629213492,0.18395252837977294,0.08777955881230448,23460,1784,0,1482,17800,3876,13101
2020-04-03,c_valenciana,C. Valenciana,John Hopkins University,6901,571,0,470,277,60,0,10,114,103.0,68,5635,695,3560,0.04181763285024154,0.11741682974559686,,0.021739130434782705,0.02064843325484511,0.1739864864864864,0.019473081328751363,6624,511,0,460,5521,592,3492
2020-04-03,asturias,Asturias,John Hopkins University,1573,83,0,91,69,3,0,3,30,36.0,23,1300,190,657,0.0458776595744681,0.03750000000000009,,0.03409090909090917,0.023622047244094446,0.23376623376623384,0.0362776025236593,1504,80,0,88,1270,154,634
2020-04-03,galicia,Galicia,John Hopkins University,5625,159,0,229,406,21,0,10,289,96.0,137,4935,531,1767,0.07779268059015143,0.15217391304347827,,0.04566210045662111,0.0622040464916056,0.2206896551724138,0.08404907975460119,5219,138,0,219,4646,435,1630
2020-04-03,madrid,Madrid,John Hopkins University,44779,4723,0,1498,1741,240,0,-8,-11,1512.0,-309,24694,15362,14741,0.04045262326316279,0.0535355788534464,,-0.005312084993359889,-0.00044525399716655034,0.10916967509025266,-0.020531561461794023,43038,4483,0,1506,24705,13850,15050
2020-04-03,andalucia,Andalucía,John Hopkins University,7847,426,0,364,494,50,0,26,239,205.0,223,6958,463,3896,0.06718346253229979,0.13297872340425543,,0.07692307692307687,0.035570769459741136,0.7945736434108528,0.060713313367819266,7353,376,0,338,6719,258,3673
2020-04-03,castilla_y_leon,Castilla y León,John Hopkins University,8332,786,0,351,457,63,0,9,132,262.0,213,5525,2021,4685,0.0580317460317461,0.08713692946058083,,0.026315789473684292,0.024476172816614072,0.14894826606026146,0.047629695885509804,7875,723,0,342,5393,1759,4472
2020-04-03,ceuta,Ceuta,John Hopkins University,73,1,0,4,11,0,0,1,11,,0,70,2,8,0.17741935483870974,0.0,,0.33333333333333326,0.18644067796610164,,0.0,62,1,0,3,59,2,8
2020-04-03,aragon,Aragón,John Hopkins University,3078,251,0,190,189,27,0,10,100,62.0,74,2387,440,1505,0.06542056074766345,0.12053571428571419,,0.05555555555555558,0.04372540445999129,0.16402116402116396,0.05171208944793859,2889,224,0,180,2287,378,1431
2020-04-03,pais_vasco,País Vasco,John Hopkins University,8187,477,0,377,360,33,0,14,38,289.0,239,4612,3098,4522,0.04599463395937131,0.07432432432432434,,0.038567493112947604,0.008307826847398392,0.10288358846564605,0.05580200793836099,7827,444,0,363,4574,2809,4283
2020-04-03,la_rioja,La Rioja,John Hopkins University,2405,128,0,64,181,19,0,0,64,98.0,67,1434,843,805,0.08138489208633093,0.17431192660550465,,0.0,0.046715328467153316,0.1315436241610739,0.0907859078590787,2224,109,0,64,1370,745,738
2020-04-03,extremadura,Extremadura,John Hopkins University,1979,208,0,64,86,8,0,0,37,41.0,38,1566,205,453,0.04543053354463811,0.040000000000000036,,0.0,0.02419882275997387,0.25,0.0915662650602409,1893,200,0,64,1529,164,415
2020-04-03,cantabria,Cantabria,John Hopkins University,1384,68,0,60,63,4,0,1,34,25.0,27,1217,99,619,0.047691143073429254,0.0625,,0.016949152542372836,0.02874049027895187,0.33783783783783794,0.045608108108108114,1321,64,0,59,1183,74,592
2020-04-04,castilla-la_mancha,Castilla-La Mancha,John Hopkins University,10031,1055,0,357,707,66,0,-3,149,492.0,-183,7827,1149,2950,0.07582582582582575,0.0667340748230536,,-0.008333333333333304,0.0194060953373274,0.7488584474885844,-0.058410469198850956,9324,989,0,360,7678,657,3133
2020-04-04,navarra,Navarra,John Hopkins University,3073,178,0,123,101,7,0,3,71,23.0,58,2561,334,1399,0.033983849259757726,0.040935672514619936,,0.02499999999999991,0.028514056224899553,0.07395498392282951,0.0432513049962715,2972,171,0,120,2490,311,1341
2020-04-04,melilla,Melilla,John Hopkins University,83,2,0,3,4,0,0,0,2,2.0,1,70,11,38,0.05063291139240511,0.0,,0.0,0.02941176470588225,0.22222222222222232,0.027027027027026973,79,2,0,3,68,9,37
2020-04-04,canarias,Canarias,John Hopkins University,1622,80,0,129,58,2,0,1,42,14.0,12,1405,137,644,0.037084398976982014,0.02564102564102555,,0.0078125,0.030814380044020595,0.11382113821138207,0.018987341772152,1564,78,0,128,1363,123,632
2020-04-04,baleares,Baleares,John Hopkins University,1293,75,0,119,22,4,0,6,-21,39.0,30,757,461,663,0.01730920535011804,0.05633802816901401,,0.053097345132743445,-0.02699228791773778,0.09241706161137442,0.04739336492891,1271,71,0,113,778,422,633
2020-04-04,murcia,Murcia,John Hopkins University,1235,59,0,80,47,8,0,1,22,17.0,13,1046,130,447,0.039562289562289576,0.15686274509803932,,0.012658227848101333,0.021484375,0.1504424778761062,0.02995391705069128,1188,51,0,79,1024,113,434
2020-04-04,cataluna,Cataluña,John Hopkins University,26032,2053,0,1653,1298,125,0,84,613,560.0,547,18830,5149,14798,0.05247836985526,0.06483402489626555,,0.053537284894837445,0.033649887467749995,0.12203094356068855,0.03838327134937902,24734,1928,0,1569,18217,4589,14251
2020-04-04,c_valenciana,C. Valenciana,John Hopkins University,7184,613,0,478,283,42,0,8,124,117.0,60,5759,812,3620,0.04100854948558186,0.0735551663747811,,0.017021276595744705,0.02200532386867793,0.1683453237410073,0.016853932584269593,6901,571,0,470,5635,695,3560
2020-04-04,asturias,Asturias,John Hopkins University,1627,87,0,93,54,4,0,2,24,26.0,17,1324,216,674,0.03432930705657977,0.04819277108433728,,0.0219780219780219,0.01846153846153853,0.13684210526315788,0.025875190258751957,1573,83,0,91,1300,190,657
2020-04-04,galicia,Galicia,John Hopkins University,5944,174,0,237,319,15,0,8,248,56.0,64,5183,587,1831,0.05671111111111116,0.09433962264150941,,0.03493449781659397,0.05025329280648427,0.10546139359698681,0.036219581211092144,5625,159,0,229,4935,531,1767
2020-04-04,madrid,Madrid,John Hopkins University,45671,4941,0,1499,892,218,0,1,-507,1181.0,-190,24187,16543,14551,0.019920051810000228,0.04615710353588831,,0.0006675567423231055,-0.02053130315056284,0.07687801067569322,-0.012889220541347224,44779,4723,0,1498,24694,15362,14741
2020-04-04,andalucia,Andalucía,John Hopkins University,8279,470,0,474,432,44,0,110,186,202.0,211,7144,665,4107,0.05505288645342166,0.10328638497652576,,0.30219780219780223,0.026731819488358788,0.4362850971922245,0.05415811088295697,7847,426,0,364,6958,463,3896
2020-04-04,castilla_y_leon,Castilla y León,John Hopkins University,8749,847,0,361,417,61,0,10,46,310.0,220,5571,2331,4905,0.05004800768122908,0.07760814249363879,,0.028490028490028463,0.008325791855203546,0.15338941118258287,0.046958377801494144,8332,786,0,351,5525,2021,4685
2020-04-04,ceuta,Ceuta,John Hopkins University,83,2,0,4,10,1,0,0,9,,1,79,2,9,0.13698630136986312,1.0,,0.0,0.12857142857142856,,0.125,73,1,0,4,70,2,8
2020-04-04,aragon,Aragón,John Hopkins University,3232,270,0,233,154,19,0,43,38,97.0,83,2425,537,1588,0.0500324886289798,0.07569721115537842,,0.22631578947368425,0.01591956430666097,0.22045454545454546,0.05514950166112964,3078,251,0,190,2387,440,1505
2020-04-04,pais_vasco,País Vasco,John Hopkins University,8628,515,0,404,441,38,0,27,96,307.0,144,4708,3405,4666,0.05386588493953837,0.07966457023060802,,0.07161803713527859,0.020815264527320076,0.09909619109102641,0.03184431667403809,8187,477,0,377,4612,3098,4522
2020-04-04,la_rioja,La Rioja,John Hopkins University,2592,134,0,66,187,6,0,2,120,61.0,50,1554,904,855,0.07775467775467781,0.046875,,0.03125,0.08368200836820083,0.07236061684460271,0.06211180124223592,2405,128,0,64,1434,843,805
2020-04-04,extremadura,Extremadura,John Hopkins University,2047,218,0,66,68,10,0,2,48,10.0,-36,1614,215,417,0.03436078827690747,0.04807692307692313,,0.03125,0.03065134099616862,0.04878048780487809,-0.07947019867549665,1979,208,0,64,1566,205,453
2020-04-04,cantabria,Cantabria,John Hopkins University,1441,68,0,62,57,0,0,2,43,14.0,20,1260,113,639,0.04118497109826591,0.0,,0.03333333333333344,0.03533278553820862,0.14141414141414144,0.03231017770597733,1384,68,0,60,1217,99,619
2020-04-05,castilla-la_mancha,Castilla-La Mancha,John Hopkins University,10602,1132,0,354,571,77,0,-3,384,110.0,-49,8211,1259,2901,0.05692353703519082,0.0729857819905213,,-0.008403361344537785,0.049060942889996184,0.09573542210617925,-0.016610169491525384,10031,1055,0,357,7827,1149,2950
2020-04-05,navarra,Navarra,John Hopkins University,3231,187,0,124,158,9,0,1,103,46.0,33,2664,380,1432,0.051415554832411337,0.050561797752809,,0.008130081300812941,0.04021866458414691,0.13772455089820368,0.02358827734095792,3073,178,0,123,2561,334,1399
2020-04-05,melilla,Melilla,John Hopkins University,86,2,0,3,3,0,0,0,3,,0,73,11,38,0.03614457831325302,0.0,,0.0,0.04285714285714293,,0.0,83,2,0,3,70,11,38
2020-04-05,canarias,Canarias,John Hopkins University,1649,85,0,133,27,5,0,4,2,20.0,7,1407,157,651,0.016646115906288506,0.0625,,0.03100775193798455,0.00142348754448407,0.14598540145985406,0.010869565217391353,1622,80,0,129,1405,137,644
2020-04-05,baleares,Baleares,John Hopkins University,1320,81,0,120,27,6,0,1,-49,70.0,19,708,531,682,0.02088167053364276,0.08000000000000007,,0.008403361344537785,-0.0647291941875826,0.15184381778741862,0.02865761689291091,1293,75,0,119,757,461,663
2020-04-05,murcia,Murcia,John Hopkins University,1259,68,0,81,24,9,0,1,-11,26.0,21,1035,156,468,0.019433198380566896,0.15254237288135597,,0.012499999999999956,-0.010516252390057379,0.19999999999999996,0.046979865771812124,1235,59,0,80,1046,130,447
2020-04-05,cataluna,Cataluña,John Hopkins University,26824,2167,0,1685,792,114,0,32,453,225.0,460,19283,5374,15258,0.030424093423478737,0.055528494885533464,,0.019358741681790637,0.024057355284121007,0.043697805399106615,0.03108528179483705,26032,2053,0,1653,18830,5149,14798
2020-04-05,c_valenciana,C. Valenciana,John Hopkins University,7334,637,0,487,150,24,0,9,8,118.0,48,5767,930,3668,0.02087973273942101,0.039151712887438794,,0.01882845188284521,0.0013891300573016796,0.14532019704433496,0.013259668508287303,7184,613,0,478,5759,812,3620
2020-04-05,asturias,Asturias,John Hopkins University,1681,93,0,94,54,6,0,1,42,6.0,21,1366,222,695,0.03318992009834054,0.06896551724137923,,0.010752688172043001,0.031722054380664666,0.02777777777777768,0.03115727002967361,1627,87,0,93,1324,216,674
2020-04-05,galicia,Galicia,John Hopkins University,6151,190,0,245,207,16,0,8,168,23.0,85,5351,610,1916,0.034825033647375436,0.09195402298850586,,0.03375527426160341,0.0324136600424465,0.03918228279386704,0.04642271982523205,5944,174,0,237,5183,587,1831
2020-04-05,madrid,Madrid,John Hopkins University,46197,5136,0,1510,526,195,0,11,-448,779.0,-50,23739,17322,14501,0.011517155306430826,0.03946569520340004,,0.007338225483655814,-0.018522346715177607,0.047089403373027805,-0.0034361899525805484,45671,4941,0,1499,24187,16543,14551
2020-04-05,andalucia,Andalucía,John Hopkins University,8559,491,0,489,280,21,0,15,126,133.0,120,7270,798,4227,0.033820509723396563,0.044680851063829685,,0.03164556962025311,0.01763717805151166,0.19999999999999996,0.029218407596786067,8279,470,0,474,7144,665,4107
2020-04-05,castilla_y_leon,Castilla y León,John Hopkins University,9116,919,0,368,367,72,0,7,93,202.0,136,5664,2533,5041,0.04194765116013266,0.08500590318772128,,0.01939058171745156,0.01669359181475505,0.08665808665808661,0.027726809378185502,8749,847,0,361,5571,2331,4905
2020-04-05,ceuta,Ceuta,John Hopkins University,83,3,0,4,0,1,0,0,-1,,0,78,2,9,0.0,0.5,,0.0,-0.012658227848101222,,0.0,83,2,0,4,79,2,9
2020-04-05,aragon,Aragón,John Hopkins University,3347,284,0,237,115,14,0,4,73,28.0,49,2498,565,1637,0.03558168316831689,0.051851851851851816,,0.01716738197424883,0.030103092783505092,0.05214152700186214,0.03085642317380355,3232,270,0,233,2425,537,1588
2020-04-05,pais_vasco,País Vasco,John Hopkins University,8810,548,0,410,182,33,0,6,-14,163.0,128,4694,3568,4794,0.021094112192860504,0.06407766990291264,,0.014851485148514865,-0.0029736618521665203,0.047870778267254055,0.027432490355765005,8628,515,0,404,4708,3405,4666
2020-04-05,la_rioja,La Rioja,John Hopkins University,2719,141,0,66,127,7,0,0,60,60.0,33,1614,964,888,0.048996913580246826,0.052238805970149294,,0.0,0.03861003861003853,0.0663716814159292,0.03859649122807007,2592,134,0,66,1554,904,855
2020-04-05,extremadura,Extremadura,John Hopkins University,2068,228,0,66,21,10,0,0,3,8.0,36,1617,223,453,0.010258915486077269,0.04587155963302747,,0.0,0.0018587360594795044,0.037209302325581506,0.08633093525179847,2047,218,0,66,1614,215,417
2020-04-05,cantabria,Cantabria,John Hopkins University,1483,77,0,65,42,9,0,3,28,5.0,19,1288,118,658,0.029146426092991007,0.13235294117647056,,0.048387096774193505,0.022222222222222143,0.04424778761061954,0.029733959311424085,1441,68,0,62,1260,113,639
2020-04-06,castilla-la_mancha,Castilla-La Mancha,John Hopkins University,11077,1177,0,360,475,45,0,6,336,94.0,7,8547,1353,2908,0.04480286738351258,0.039752650176678506,,0.016949152542372836,0.04092071611253201,0.07466243050039711,0.0024129610479144414,10602,1132,0,354,8211,1259,2901
2020-04-06,navarra,Navarra,John Hopkins University,3355,202,0,124,124,15,0,0,68,41.0,56,2732,421,1488,0.03837821108016093,0.0802139037433156,,0.0,0.02552552552552556,0.10789473684210527,0.03910614525139655,3231,187,0,124,2664,380,1432
2020-04-06,melilla,Melilla,John Hopkins University,92,2,0,3,6,0,0,0,6,,2,79,11,40,0.06976744186046502,0.0,,0.0,0.08219178082191791,,0.05263157894736836,86,2,0,3,73,11,38
2020-04-06,canarias,Canarias,John Hopkins University,1725,89,0,137,76,4,0,4,43,29.0,38,1450,186,689,0.04608853850818684,0.04705882352941182,,0.03007518796992481,0.03056147832267242,0.1847133757961783,0.05837173579109067,1649,85,0,133,1407,157,651
2020-04-06,baleares,Baleares,John Hopkins University,1369,84,0,123,49,3,0,3,40,6.0,22,748,537,704,0.03712121212121211,0.03703703703703698,,0.02499999999999991,0.05649717514124286,0.011299435028248483,0.032258064516129004,1320,81,0,120,708,531,682
2020-04-06,murcia,Murcia,John Hopkins University,1259,78,0,84,0,10,0,3,-47,37.0,32,988,193,500,0.0,0.1470588235294117,,0.03703703703703698,-0.04541062801932372,0.23717948717948723,0.06837606837606836,1259,68,0,81,1035,156,468
2020-04-06,cataluna,Cataluña,John Hopkins University,28323,2329,0,1740,1499,162,0,55,561,776.0,385,19844,6150,15643,0.05588279152997311,0.07475772958006455,,0.03264094955489605,0.0290929834569309,0.14439895794566437,0.025232664831563723,26824,2167,0,1685,19283,5374,15258
2020-04-06,c_valenciana,C. Valenciana,John Hopkins University,7443,672,0,492,109,35,0,5,-99,173.0,30,5668,1103,3698,0.01486228524679567,0.05494505494505497,,0.010266940451745477,-0.0171666377666031,0.1860215053763441,0.008178844056706547,7334,637,0,487,5767,930,3668
2020-04-06,asturias,Asturias,John Hopkins University,1702,101,0,96,21,8,0,2,-9,22.0,32,1357,244,727,0.012492563950029734,0.08602150537634401,,0.02127659574468077,-0.0065885797950219205,0.0990990990990992,0.04604316546762588,1681,93,0,94,1366,222,695
2020-04-06,galicia,Galicia,John Hopkins University,6331,204,0,253,180,14,0,8,88,78.0,52,5439,688,1968,0.02926353438465301,0.0736842105263158,,0.03265306122448974,0.016445524201083916,0.12786885245901636,0.02713987473903967,6151,190,0,245,5351,610,1916
2020-04-06,madrid,Madrid,John Hopkins University,47763,5371,0,1494,1566,235,0,-16,243,1088.0,-551,23982,18410,13950,0.03389830508474567,0.04575545171339557,,-0.01059602649006619,0.01023631997978014,0.062810299041681,-0.03799737949106963,46197,5136,0,1510,23739,17322,14501
2020-04-06,andalucia,Andalucía,John Hopkins University,8743,528,0,499,184,37,0,10,45,102.0,108,7315,900,4335,0.021497838532538838,0.07535641547861505,,0.020449897750511203,0.0061898211829436445,0.1278195488721805,0.025550035486160416,8559,491,0,489,7270,798,4227
2020-04-06,castilla_y_leon,Castilla y León,John Hopkins University,9581,982,0,375,465,63,0,7,224,178.0,139,5888,2711,5180,0.05100921456779295,0.06855277475516863,,0.01902173913043481,0.039548022598870025,0.07027240426371884,0.027573894068637195,9116,919,0,368,5664,2533,5041
2020-04-06,ceuta,Ceuta,John Hopkins University,83,4,0,4,0,1,0,0,-1,,0,77,2,9,0.0,0.33333333333333326,,0.0,-0.012820512820512775,,0.0,83,3,0,4,78,2,9
2020-04-06,aragon,Aragón,John Hopkins University,3449,312,0,247,102,28,0,10,61,13.0,26,2559,578,1663,0.030475052285628967,0.09859154929577474,,0.04219409282700415,0.024419535628502853,0.023008849557522026,0.01588271227855831,3347,284,0,237,2498,565,1637
2020-04-06,pais_vasco,País Vasco,John Hopkins University,8974,586,0,417,164,38,0,7,-34,160.0,62,4660,3728,4856,0.018615209988649184,0.06934306569343063,,0.017073170731707332,-0.0072432893054963365,0.04484304932735417,0.012932832707551078,8810,548,0,410,4694,3568,4794
2020-04-06,la_rioja,La Rioja,John Hopkins University,2846,160,0,66,127,19,0,0,78,30.0,30,1692,994,918,0.04670834865759477,0.13475177304964547,,0.0,0.048327137546468446,0.03112033195020736,0.03378378378378377,2719,141,0,66,1614,964,888
2020-04-06,extremadura,Extremadura,John Hopkins University,2116,258,0,70,48,30,0,4,-41,59.0,233,1576,282,686,0.023210831721470093,0.13157894736842102,,0.06060606060606055,-0.02535559678416821,0.26457399103139023,0.5143487858719646,2068,228,0,66,1617,223,453
2020-04-06,cantabria,Cantabria,John Hopkins University,1501,85,0,66,18,8,0,1,-1,11.0,19,1287,129,677,0.012137559002022957,0.10389610389610393,,0.01538461538461533,-0.0007763975155279379,0.09322033898305082,0.028875379939209633,1483,77,0,65,1288,118,658
2020-04-07,castilla-la_mancha,Castilla-La Mancha,John Hopkins University,11788,1255,0,354,711,78,0,-6,429.0,204,-177,8976,1557,2731,0.06418705425656768,0.06627017841971106,,-0.01666666666666672,0.05019305019305009,0.1507760532150777,-0.0608665749656121,11077,1177,0,360,8547,1353,2908
2020-04-07,navarra,Navarra,John Hopkins University,3467,206,0,124,112,4,0,0,79.0,29,38,2811,450,1526,0.03338301043219083,0.01980198019801982,,0.0,0.028916544655929632,0.06888361045130642,0.02553763440860224,3355,202,0,124,2732,421,1488
2020-04-07,melilla,Melilla,John Hopkins University,93,2,0,3,1,0,0,0,,1,0,79,12,40,0.010869565217391353,0.0,,0.0,,0.09090909090909083,0.0,92,2,0,3,79,11,40
2020-04-07,canarias,Canarias,John Hopkins University,1762,91,0,138,37,2,0,1,-28.0,63,14,1422,249,703,0.021449275362318776,0.022471910112359605,,0.007299270072992803,-0.0193103448275862,0.33870967741935476,0.020319303338171224,1725,89,0,137,1450,186,689
2020-04-07,baleares,Baleares,John Hopkins University,1412,89,0,128,43,5,0,5,-41.0,79,26,707,616,730,0.03140978816654494,0.059523809523809534,,0.04065040650406515,-0.05481283422459893,0.14711359404096824,0.03693181818181812,1369,84,0,123,748,537,704
2020-04-07,murcia,Murcia,John Hopkins University,1297,85,0,86,38,7,0,2,21.0,10,15,1009,203,515,0.030182684670373217,0.08974358974358965,,0.023809523809523725,0.021255060728744946,0.051813471502590636,0.030000000000000027,1259,78,0,84,988,193,500
2020-04-07,cataluna,Cataluña,John Hopkins University,29647,2462,0,1829,1324,133,0,89,21.0,1170,592,19865,7320,16235,0.04674646047381992,0.0571060541004722,,0.05114942528735633,0.0010582543841968217,0.19024390243902434,0.03784440324745897,28323,2329,0,1740,19844,6150,15643
2020-04-07,c_valenciana,C. Valenciana,John Hopkins University,7655,724,0,496,212,52,0,4,-81.0,241,15,5587,1344,3713,0.028483138519414197,0.07738095238095233,,0.008130081300812941,-0.014290755116443177,0.2184950135992747,0.004056246619794424,7443,672,0,492,5668,1103,3698
2020-04-07,asturias,Asturias,John Hopkins University,1729,107,0,97,27,6,0,1,-29.0,50,20,1328,294,747,0.015863689776733247,0.05940594059405946,,0.01041666666666674,-0.021370670596904895,0.20491803278688514,0.02751031636863832,1702,101,0,96,1357,244,727
2020-04-07,galicia,Galicia,John Hopkins University,6538,213,0,256,207,9,0,3,86.0,112,46,5525,800,2014,0.03269625651555841,0.044117647058823595,,0.011857707509881354,0.0158117300974443,0.16279069767441867,0.023373983739837456,6331,204,0,253,5439,688,1968
2020-04-07,madrid,Madrid,John Hopkins University,49160,5586,0,1450,1397,215,0,-44,-244.0,1426,-661,23738,19836,13289,0.029248581538010576,0.04002978961087322,,-0.029451137884872858,-0.010174297389708986,0.07745790331341662,-0.047383512544802886,47763,5371,0,1494,23982,18410,13950
2020-04-07,andalucia,Andalucía,John Hopkins University,8973,605,0,520,230,77,0,21,12.0,141,128,7327,1041,4463,0.026306759693468962,0.14583333333333326,,0.04208416833667328,0.0016404647983594423,0.15666666666666673,0.029527104959630845,8743,528,0,499,7315,900,4335
2020-04-07,castilla_y_leon,Castilla y León,John Hopkins University,10058,1028,0,386,477,46,0,11,154.0,277,142,6042,2988,5322,0.0497860348606618,0.046843177189409335,,0.029333333333333433,0.026154891304347894,0.10217631870158606,0.027413127413127514,9581,982,0,375,5888,2711,5180
2020-04-07,ceuta,Ceuta,John Hopkins University,84,4,0,4,1,0,0,0,-4.0,5,0,73,7,9,0.012048192771084265,0.0,,0.0,-0.051948051948051965,2.5,0.0,83,4,0,4,77,2,9
2020-04-07,aragon,Aragón,John Hopkins University,3549,349,0,255,100,37,0,8,-18.0,81,53,2541,659,1716,0.02899391127863149,0.11858974358974361,,0.03238866396761142,-0.007033997655334079,0.1401384083044983,0.03187011425135289,3449,312,0,247,2559,578,1663
2020-04-07,pais_vasco,País Vasco,John Hopkins University,9392,635,0,430,418,49,0,13,-54.0,423,126,4606,4151,4982,0.04657900601738363,0.08361774744027306,,0.031175059952038398,-0.011587982832617971,0.1134656652360515,0.025947281713344372,8974,586,0,417,4660,3728,4856
2020-04-07,la_rioja,La Rioja,John Hopkins University,2951,177,0,68,105,17,0,2,21.0,67,37,1713,1061,955,0.036893886156008415,0.10624999999999996,,0.030303030303030276,0.012411347517730542,0.06740442655935608,0.04030501089324612,2846,160,0,66,1692,994,918
2020-04-07,extremadura,Extremadura,John Hopkins University,2184,271,0,98,68,13,0,28,9.0,46,212,1585,328,898,0.032136105860113506,0.050387596899224896,,0.3999999999999999,0.005710659898477077,0.16312056737588643,0.30903790087463556,2116,258,0,70,1576,282,686
2020-04-07,cantabria,Cantabria,John Hopkins University,1572,92,0,69,71,7,0,3,18.0,46,23,1305,175,700,0.047301798800799544,0.08235294117647052,,0.045454545454545414,0.013986013986013957,0.3565891472868217,0.033973412112259904,1501,85,0,66,1287,129,677
2020-04-08,castilla-la_mancha,Castilla-La Mancha,John Hopkins University,12489,1322,0,342,701,67,0,-12,425.0,209.0,-156,9401,1766,2575,0.05946725483542581,0.05338645418326693,,-0.03389830508474578,0.04734848484848486,0.13423249839434814,-0.0571219333577444,11788,1255,0,354,8976,1557,2731
2020-04-08,navarra,Navarra,John Hopkins University,3575,214,0,124,108,8,0,0,88.0,12.0,0,2899,462,1526,0.031150850879723135,0.03883495145631066,,0.0,0.03130558520099602,0.026666666666666616,0.0,3467,206,0,124,2811,450,1526
2020-04-08,melilla,Melilla,John Hopkins University,93,2,0,3,0,0,0,0,-4.0,4.0,0,75,16,40,0.0,0.0,,0.0,-0.05063291139240511,0.33333333333333326,0.0,93,2,0,3,79,12,40
2020-04-08,canarias,Canarias,John Hopkins University,1834,92,0,140,72,1,0,2,-39.0,110.0,27,1383,359,730,0.04086265607264483,0.01098901098901095,,0.01449275362318847,-0.02742616033755274,0.4417670682730923,0.038406827880512084,1762,91,0,138,1422,249,703
2020-04-08,baleares,Baleares,John Hopkins University,1448,89,0,131,36,0,0,3,-44.0,80.0,20,663,696,750,0.025495750708215192,0.0,,0.0234375,-0.062234794908062274,0.1298701298701299,0.027397260273972712,1412,89,0,128,707,616,730
2020-04-08,murcia,Murcia,John Hopkins University,1322,88,0,87,25,3,0,1,6.0,16.0,18,1015,219,533,0.019275250578257408,0.03529411764705892,,0.011627906976744207,0.005946481665014769,0.07881773399014769,0.03495145631067964,1297,85,0,86,1009,203,515
2020-04-08,cataluna,Cataluña,John Hopkins University,31043,2667,0,1946,1396,205,0,117,497.0,694.0,735,20362,8014,16970,0.04708739501467263,0.0832656376929326,,0.06396938217605252,0.02501887742260256,0.09480874316939891,0.04527255928549434,29647,2462,0,1829,19865,7320,16235
2020-04-08,c_valenciana,C. Valenciana,John Hopkins University,7964,767,0,541,309,43,0,45,-162.0,428.0,102,5425,1772,3815,0.04036577400391894,0.059392265193370264,,0.09072580645161299,-0.028995883300519054,0.31845238095238093,0.02747104767034747,7655,724,0,496,5587,1344,3713
2020-04-08,asturias,Asturias,John Hopkins University,1774,113,0,100,45,6,0,3,-7.0,46.0,28,1321,340,775,0.026026604973973466,0.05607476635514019,,0.030927835051546282,-0.005271084337349352,0.15646258503401356,0.03748326639892907,1729,107,0,97,1328,294,747
2020-04-08,galicia,Galicia,John Hopkins University,6758,231,0,260,220,18,0,4,92.0,110.0,80,5617,910,2094,0.0336494340776996,0.08450704225352124,,0.015625,0.016651583710407314,0.13749999999999996,0.03972194637537241,6538,213,0,256,5525,800,2014
2020-04-08,madrid,Madrid,John Hopkins University,50580,5800,0,1433,1420,214,0,-17,-79.0,1285.0,-436,23659,21121,12853,0.02888527257933271,0.038310060866451945,,-0.01172413793103444,-0.003327997303900876,0.06478120588828395,-0.032809090224998116,49160,5586,0,1450,23738,19836,13289
2020-04-08,andalucia,Andalucía,John Hopkins University,9234,652,0,538,261,47,0,18,62.0,152.0,136,7389,1193,4599,0.029087261785356144,0.07768595041322324,,0.034615384615384714,0.008461853418861853,0.14601344860710852,0.030472776159534032,8973,605,0,520,7327,1041,4463
2020-04-08,castilla_y_leon,Castilla y León,John Hopkins University,10518,1082,0,399,460,54,0,13,152.0,254.0,201,6194,3242,5523,0.04573473851660359,0.05252918287937747,,0.033678756476683835,0.02515723270440251,0.08500669344042833,0.037767756482525394,10058,1028,0,386,6042,2988,5322
2020-04-08,ceuta,Ceuta,John Hopkins University,84,4,0,4,0,0,0,0,,,0,73,7,9,0.0,0.0,,0.0,,,0.0,84,4,0,4,73,7,9
2020-04-08,aragon,Aragón,John Hopkins University,3685,385,0,261,136,36,0,6,41.0,59.0,49,2582,718,1765,0.03832065370526916,0.1031518624641834,,0.0235294117647058,0.016135379771743397,0.08952959028831553,0.028554778554778615,3549,349,0,255,2541,659,1716
2020-04-08,pais_vasco,País Vasco,John Hopkins University,9740,689,0,433,348,54,0,3,-69.0,363.0,148,4537,4514,5130,0.03705281090289603,0.08503937007874018,,0.006976744186046435,-0.014980460269214069,0.08744880751626116,0.029706945002007323,9392,635,0,430,4606,4151,4982
2020-04-08,la_rioja,La Rioja,John Hopkins University,3026,182,0,69,75,5,0,1,-41.0,111.0,42,1672,1172,997,0.02541511352084047,0.02824858757062154,,0.014705882352941124,-0.023934617629889132,0.10461828463713485,0.043979057591623016,2951,177,0,68,1713,1061,955
2020-04-08,extremadura,Extremadura,John Hopkins University,2273,283,0,99,89,12,0,1,24.0,53.0,60,1609,381,958,0.04075091575091583,0.04428044280442811,,0.010204081632652962,0.015141955835962229,0.16158536585365857,0.06681514476614692,2184,271,0,98,1585,328,898
2020-04-08,cantabria,Cantabria,John Hopkins University,1619,98,0,71,47,6,0,2,2.0,39.0,20,1307,214,720,0.029898218829516487,0.0652173913043479,,0.02898550724637672,0.0015325670498085309,0.22285714285714286,0.02857142857142847,1572,92,0,69,1305,175,700
2020-04-09,castilla-la_mancha,Castilla-La Mancha,John Hopkins University,13063,1431,0,329,574,109,0,-13,249.0,216,-216,9650,1982,2359,0.045960445191768784,0.08245083207261716,,-0.03801169590643272,0.02648654398468242,0.1223103057757644,-0.08388349514563109,12489,1322,0,342,9401,1766,2575
2020-04-09,navarra,Navarra,John Hopkins University,3748,218,0,124,173,4,0,0,71.0,98,94,2970,560,1620,0.0483916083916085,0.01869158878504673,,0.0,0.02449120386340109,0.21212121212121215,0.0615989515072084,3575,214,0,124,2899,462,1526
2020-04-09,melilla,Melilla,John Hopkins University,95,2,0,3,2,0,0,0,1.0,1,1,76,17,41,0.021505376344086002,0.0,,0.0,0.01333333333333342,0.0625,0.02499999999999991,93,2,0,3,75,16,40
2020-04-09,canarias,Canarias,John Hopkins University,1858,94,0,141,24,2,0,1,-5.0,27,8,1378,386,738,0.013086150490730697,0.021739130434782705,,0.0071428571428571175,-0.003615328994938549,0.07520891364902504,0.010958904109588996,1834,92,0,140,1383,359,730
2020-04-09,baleares,Baleares,John Hopkins University,1488,97,0,135,40,8,0,4,-9.0,41,26,654,737,776,0.027624309392265234,0.0898876404494382,,0.03053435114503822,-0.013574660633484115,0.05890804597701149,0.03466666666666662,1448,89,0,131,663,696,750
2020-04-09,murcia,Murcia,John Hopkins University,1338,90,0,88,16,2,0,1,-22.0,36,0,993,255,533,0.012102874432677657,0.022727272727272707,,0.011494252873563315,-0.021674876847290636,0.1643835616438356,0.0,1322,88,0,87,1015,219,533
2020-04-09,cataluna,Cataluña,John Hopkins University,31824,2787,0,1966,781,120,0,20,-30.0,691,810,20332,8705,17780,0.025158650903585267,0.044994375703037104,,0.010277492291880685,-0.0014733326785187906,0.08622410781133016,0.047731290512669444,31043,2667,0,1946,20362,8014,16970
2020-04-09,c_valenciana,C. Valenciana,John Hopkins University,8331,796,0,561,367,29,0,20,25.0,313,172,5450,2085,3987,0.04608237066800602,0.03780964797913944,,0.0369685767097967,0.004608294930875667,0.17663656884875856,0.045085190039318546,7964,767,0,541,5425,1772,3815
2020-04-09,asturias,Asturias,John Hopkins University,1822,129,0,100,48,16,0,0,,32,22,1321,372,797,0.027057497181510737,0.1415929203539823,,0.0,,0.09411764705882364,0.028387096774193488,1774,113,0,100,1321,340,775
2020-04-09,galicia,Galicia,John Hopkins University,6946,243,0,263,188,12,0,3,89.0,87,71,5706,997,2165,0.027818881325835987,0.051948051948051965,,0.011538461538461497,0.015844756987715813,0.09560439560439571,0.0339063992359121,6758,231,0,260,5617,910,2094
2020-04-09,madrid,Madrid,John Hopkins University,51535,5972,0,1399,955,172,0,-34,-510.0,1293,-421,23149,22414,12432,0.018880980624752963,0.029655172413793007,,-0.023726448011165413,-0.02155627879453903,0.06121869229676635,-0.032754998832957294,50580,5800,0,1433,23659,21121,12853
2020-04-09,andalucia,Andalucía,John Hopkins University,9482,691,0,582,248,39,0,44,-35.0,244,116,7354,1437,4715,0.02685726662334842,0.059815950920245387,,0.08178438661710041,-0.004736770875625962,0.20452640402347022,0.02522287453794303,9234,652,0,538,7389,1193,4599
2020-04-09,castilla_y_leon,Castilla y León,John Hopkins University,11102,1129,0,407,584,47,0,8,273.0,264,151,6467,3506,5674,0.055523863852443345,0.043438077634011085,,0.020050125313283207,0.04407491120439144,0.08143121529919806,0.027340213652000678,10518,1082,0,399,6194,3242,5523
2020-04-09,ceuta,Ceuta,John Hopkins University,91,4,0,4,7,0,0,0,2.0,5,0,75,12,9,0.08333333333333326,0.0,,0.0,0.027397260273972712,0.7142857142857142,0.0,84,4,0,4,73,7,9
2020-04-09,aragon,Aragón,John Hopkins University,3831,409,0,263,146,24,0,2,43.0,79,57,2625,797,1822,0.03962008141112627,0.06233766233766236,,0.00766283524904221,0.016653756777691653,0.11002785515320324,0.0322946175637393,3685,385,0,261,2582,718,1765
2020-04-09,pais_vasco,País Vasco,John Hopkins University,9992,729,0,442,252,40,0,9,46.0,166,160,4583,4680,5290,0.025872689938398308,0.05805515239477499,,0.020785219399538146,0.010138858276394158,0.03677447939743028,0.031189083820662766,9740,689,0,433,4537,4514,5130
2020-04-09,la_rioja,La Rioja,John Hopkins University,3076,196,0,71,50,14,0,2,-48.0,84,50,1624,1256,1047,0.016523463317911435,0.07692307692307687,,0.02898550724637672,-0.028708133971291905,0.07167235494880542,0.050150451354062264,3026,182,0,69,1672,1172,997
2020-04-09,extremadura,Extremadura,John Hopkins University,2332,288,0,101,59,5,0,2,38.0,16,45,1647,397,1003,0.025956885173779254,0.0176678445229681,,0.02020202020202011,0.023617153511497735,0.04199475065616798,0.04697286012526103,2273,283,0,99,1609,381,958
2020-04-09,cantabria,Cantabria,John Hopkins University,1659,102,0,73,40,4,0,2,-15.0,51,27,1292,265,747,0.024706609017912218,0.04081632653061229,,0.028169014084507005,-0.011476664116296886,0.23831775700934577,0.03750000000000009,1619,98,0,71,1307,214,720
2020-04-10,castilla-la_mancha,Castilla-La Mancha,John Hopkins University,13456,1483,0,316,393,52,0,-13,118,223,-161,9768,2205,2198,0.030084972824006684,0.036338225017470194,,-0.03951367781155013,0.012227979274611389,0.11251261352169517,-0.06824925816023741,13063,1431,0,329,9650,1982,2359
2020-04-10,navarra,Navarra,John Hopkins University,3817,227,0,124,69,9,0,0,17,43,21,2987,603,1641,0.01840981856990398,0.041284403669724856,,0.0,0.005723905723905798,0.07678571428571423,0.012962962962963065,3748,218,0,124,2970,560,1620
2020-04-10,melilla,Melilla,John Hopkins University,98,2,0,3,3,0,0,0,2,1,2,78,18,43,0.03157894736842115,0.0,,0.0,0.026315789473684292,0.05882352941176472,0.04878048780487809,95,2,0,3,76,17,41
2020-04-10,canarias,Canarias,John Hopkins University,1887,95,0,144,29,1,0,3,-18,46,7,1360,432,745,0.015608180839612462,0.010638297872340496,,0.02127659574468077,-0.013062409288824406,0.11917098445595853,0.009485094850948617,1858,94,0,141,1378,386,738
2020-04-10,baleares,Baleares,John Hopkins University,1507,102,0,136,19,5,0,1,-6,20,1,648,757,777,0.012768817204301008,0.05154639175257736,,0.007407407407407307,-0.00917431192660545,0.027137042062415295,0.0012886597938144284,1488,97,0,135,654,737,776
2020-04-10,murcia,Murcia,John Hopkins University,1371,94,0,88,33,4,0,0,9,20,0,1002,275,533,0.024663677130044803,0.04444444444444451,,0.0,0.009063444108761365,0.07843137254901955,0.0,1338,90,0,88,993,255,533
2020-04-10,cataluna,Cataluña,John Hopkins University,32984,2877,0,1989,1160,90,0,23,508,562,414,20840,9267,18194,0.03645047762694831,0.03229278794402579,,0.011698880976602322,0.02498524493409393,0.06456059735784025,0.02328458942632161,31824,2787,0,1966,20332,8705,17780
2020-04-10,c_valenciana,C. Valenciana,John Hopkins University,8578,818,0,565,247,22,0,4,21,204,145,5471,2289,4132,0.02964830152442688,0.027638190954773822,,0.007130124777183555,0.00385321100917424,0.09784172661870505,0.03636819663907698,8331,796,0,561,5450,2085,3987
2020-04-10,asturias,Asturias,John Hopkins University,1865,134,0,101,43,5,0,1,-4,42,34,1317,414,831,0.023600439077936297,0.03875968992248069,,0.010000000000000009,-0.003028009084027228,0.11290322580645151,0.042659974905897124,1822,129,0,100,1321,372,797
2020-04-10,galicia,Galicia,John Hopkins University,7176,261,0,264,230,18,0,1,127,85,50,5833,1082,2215,0.0331125827814569,0.07407407407407418,,0.0038022813688212143,0.022257273045916515,0.08525576730190565,0.023094688221708903,6946,243,0,263,5706,997,2165
2020-04-10,madrid,Madrid,John Hopkins University,52400,6084,0,1376,865,112,0,-23,-496,1249,-538,22653,23663,11894,0.01678470942078203,0.018754186202277312,,-0.01644031451036454,-0.021426411508056464,0.05572410100829828,-0.043275418275418254,51535,5972,0,1399,23149,22414,12432
2020-04-10,andalucia,Andalucía,John Hopkins University,9682,737,0,602,200,46,0,20,-39,193,93,7315,1630,4808,0.021092596498629046,0.06657018813314042,,0.03436426116838498,-0.005303236333967898,0.13430758524704256,0.019724284199363673,9482,691,0,582,7354,1437,4715
2020-04-10,castilla_y_leon,Castilla y León,John Hopkins University,11543,1180,0,414,441,51,0,7,139,251,143,6606,3757,5817,0.039722572509457654,0.04517271922054911,,0.017199017199017286,0.02149373743621452,0.07159155733029099,0.025202678886147245,11102,1129,0,407,6467,3506,5674
2020-04-10,ceuta,Ceuta,John Hopkins University,93,4,0,4,2,0,0,0,-3,5,0,72,17,9,0.0219780219780219,0.0,,0.0,-0.040000000000000036,0.41666666666666674,0.0,91,4,0,4,75,12,9
2020-04-10,aragon,Aragón,John Hopkins University,3969,425,0,266,138,16,0,3,31,91,38,2656,888,1860,0.03602192638997659,0.03911980440097795,,0.011406844106463865,0.011809523809523714,0.11417816813048942,0.020856201975850697,3831,409,0,263,2625,797,1822
2020-04-10,pais_vasco,País Vasco,John Hopkins University,10313,765,0,453,321,36,0,11,224,61,112,4807,4741,5402,0.03212570056044828,0.04938271604938271,,0.02488687782805421,0.04887628191141169,0.013034188034187988,0.021172022684309955,9992,729,0,442,4583,4680,5290
2020-04-10,la_rioja,La Rioja,John Hopkins University,3223,207,0,73,147,11,0,2,55,81,35,1679,1337,1082,0.04778933680104025,0.05612244897959173,,0.028169014084507005,0.03386699507389168,0.06449044585987251,0.03342884431709647,3076,196,0,71,1624,1256,1047
2020-04-10,extremadura,Extremadura,John Hopkins University,2486,303,0,104,154,15,0,3,74,65,49,1721,462,1052,0.0660377358490567,0.05208333333333326,,0.02970297029702973,0.04493017607771699,0.16372795969773302,0.048853439680957234,2332,288,0,101,1647,397,1003
2020-04-10,cantabria,Cantabria,John Hopkins University,1719,107,0,75,60,5,0,2,39,16,26,1331,281,773,0.03616636528028927,0.0490196078431373,,0.027397260273972712,0.030185758513931793,0.060377358490566024,0.03480589022757696,1659,102,0,73,1292,265,747
2020-04-11,castilla-la_mancha,Castilla-La Mancha,John Hopkins University,13698,1543,0,316,242,60,0,0,22.0,160.0,4640,9790,2365,6838,0.017984542211652688,0.04045853000674304,,0.0,0.0022522522522523403,0.07256235827664392,2.1110100090991812,13456,1483,0,316,9768,2205,2198
2020-04-11,navarra,Navarra,John Hopkins University,3969,232,0,124,152,5,0,0,100.0,47.0,22,3087,650,1663,0.039821849620120586,0.022026431718061623,,0.0,0.033478406427853935,0.07794361525704807,0.013406459475929333,3817,227,0,124,2987,603,1641
2020-04-11,melilla,Melilla,John Hopkins University,98,2,0,3,0,0,0,0,,,0,78,18,43,0.0,0.0,,0.0,,,0.0,98,2,0,3,78,18,43
2020-04-11,canarias,Canarias,John Hopkins University,1918,95,0,144,31,0,0,0,16.0,15.0,13,1376,447,758,0.016428192898781058,0.0,,0.0,0.0117647058823529,0.03472222222222232,0.01744966442953011,1887,95,0,144,1360,432,745
2020-04-11,baleares,Baleares,John Hopkins University,1534,112,0,141,27,10,0,5,-74.0,91.0,27,574,848,804,0.01791639017916391,0.0980392156862746,,0.03676470588235303,-0.11419753086419748,0.120211360634082,0.03474903474903468,1507,102,0,136,648,757,777
2020-04-11,murcia,Murcia,John Hopkins University,1380,97,0,91,9,3,0,3,-63.0,69.0,4,939,344,537,0.006564551422319376,0.03191489361702127,,0.03409090909090917,-0.06287425149700598,0.25090909090909097,0.007504690431519689,1371,94,0,88,1002,275,533
2020-04-11,cataluna,Cataluña,John Hopkins University,34027,2975,0,2018,1043,98,0,29,602.0,343.0,578,21442,9610,18772,0.0316213921901527,0.03406326034063256,,0.014580191050779234,0.02888675623800374,0.03701305708427749,0.03176871496097622,32984,2877,0,1989,20840,9267,18194
2020-04-11,c_valenciana,C. Valenciana,John Hopkins University,8841,838,0,567,263,20,0,2,-92.0,335.0,17,5379,2624,4149,0.0306598274656098,0.02444987775061125,,0.003539823008849474,-0.016815938585267753,0.14635211882918298,0.004114230396902174,8578,818,0,565,5471,2289,4132
2020-04-11,asturias,Asturias,John Hopkins University,1949,150,0,102,84,16,0,1,52.0,16.0,32,1369,430,863,0.04504021447721174,0.11940298507462677,,0.00990099009900991,0.039483675018982645,0.03864734299516903,0.038507821901323736,1865,134,0,101,1317,414,831
2020-04-11,galicia,Galicia,John Hopkins University,7336,274,0,267,160,13,0,3,86.0,61.0,91,5919,1143,2306,0.02229654403567438,0.04980842911877392,,0.011363636363636465,0.014743699639979457,0.05637707948243986,0.04108352144469518,7176,261,0,264,5833,1082,2215
2020-04-11,madrid,Madrid,John Hopkins University,52944,6278,0,1332,544,194,0,-44,-670.0,1020.0,-470,21983,24683,11424,0.010381679389313003,0.03188691650230102,,-0.03197674418604646,-0.029576656513486066,0.043105269830537196,-0.039515722212880466,52400,6084,0,1376,22653,23663,11894
2020-04-11,andalucia,Andalucía,John Hopkins University,9976,799,0,619,294,62,0,17,24.0,208.0,142,7339,1838,4950,0.03036562693658329,0.08412483039348717,,0.028239202657807327,0.0032809295967191066,0.1276073619631901,0.029534109816971688,9682,737,0,602,7315,1630,4808
2020-04-11,castilla_y_leon,Castilla y León,John Hopkins University,12118,1221,0,418,575,41,0,4,281.0,253.0,140,6887,4010,5957,0.04981373992896132,0.03474576271186436,,0.009661835748792313,0.04253708749621565,0.06734096353473507,0.024067388688327362,11543,1180,0,414,6606,3757,5817
2020-04-11,ceuta,Ceuta,John Hopkins University,93,4,0,4,0,0,0,0,,,0,72,17,9,0.0,0.0,,0.0,,,0.0,93,4,0,4,72,17,9
2020-04-11,aragon,Aragón,John Hopkins University,4070,450,0,272,101,25,0,6,30.0,46.0,41,2686,934,1901,0.025447215923406485,0.05882352941176472,,0.022556390977443552,0.011295180722891596,0.05180180180180183,0.022043010752688108,3969,425,0,266,2656,888,1860
2020-04-11,pais_vasco,País Vasco,John Hopkins University,10514,804,0,459,201,39,0,6,36.0,126.0,145,4843,4867,5547,0.019489964122951564,0.050980392156862786,,0.013245033112582849,0.007489078427293627,0.026576671588272482,0.026841910403554214,10313,765,0,453,4807,4741,5402
2020-04-11,la_rioja,La Rioja,John Hopkins University,3279,219,0,73,56,12,0,0,-39.0,83.0,40,1640,1420,1122,0.01737511635122546,0.05797101449275366,,0.0,-0.023228111971411503,0.06207928197456991,0.0369685767097967,3223,207,0,73,1679,1337,1082
2020-04-11,extremadura,Extremadura,John Hopkins University,2580,312,0,106,94,9,0,2,66.0,19.0,22,1787,481,1074,0.037811745776347605,0.02970297029702973,,0.019230769230769162,0.03834979662986626,0.04112554112554112,0.02091254752851701,2486,303,0,104,1721,462,1052
2020-04-11,cantabria,Cantabria,John Hopkins University,1752,110,0,75,33,3,0,0,14.0,16.0,32,1345,297,805,0.01919720767888311,0.028037383177569986,,0.0,0.010518407212622094,0.05693950177935947,0.04139715394566634,1719,107,0,75,1331,281,773
2020-04-12,castilla-la_mancha,Castilla-La Mancha,John Hopkins University,14054,1626,0,475,356,83,0,159,106,167.0,944,9896,2532,7782,0.025989195502993168,0.05379131561892425,,0.5031645569620253,0.010827374872318662,0.07061310782241015,0.13805206200643472,13698,1543,0,316,9790,2365,6838
2020-04-12,navarra,Navarra,John Hopkins University,4092,239,0,124,123,7,0,0,71,45.0,30,3158,695,1693,0.030990173847316616,0.030172413793103425,,0.0,0.022999676060900587,0.0692307692307692,0.018039687312086494,3969,232,0,124,3087,650,1663
2020-04-12,melilla,Melilla,John Hopkins University,101,2,0,3,3,0,0,0,3,,0,81,18,43,0.030612244897959107,0.0,,0.0,0.03846153846153855,,0.0,98,2,0,3,78,18,43
2020-04-12,canarias,Canarias,John Hopkins University,1944,96,0,145,26,1,0,1,14,11.0,5,1390,458,763,0.01355578727841511,0.010526315789473717,,0.00694444444444442,0.01017441860465107,0.02460850111856816,0.006596306068601621,1918,95,0,144,1376,447,758
2020-04-12,baleares,Baleares,John Hopkins University,1550,117,0,142,16,5,0,1,-3,14.0,6,571,862,810,0.010430247718383301,0.044642857142857206,,0.007092198581560183,-0.005226480836236891,0.01650943396226423,0.00746268656716409,1534,112,0,141,574,848,804
2020-04-12,murcia,Murcia,John Hopkins University,1387,101,0,94,7,4,0,3,-6,9.0,6,933,353,543,0.005072463768115876,0.04123711340206193,,0.03296703296703307,-0.006389776357827448,0.026162790697674465,0.011173184357541999,1380,97,0,91,939,344,537
2020-04-12,cataluna,Cataluña,John Hopkins University,34726,3105,0,2084,699,130,0,66,139,430.0,191,21581,10040,18963,0.020542510359420563,0.043697478991596705,,0.03270564915758167,0.006482604234679501,0.04474505723205002,0.01017472831877253,34027,2975,0,2018,21442,9610,18772
2020-04-12,c_valenciana,C. Valenciana,John Hopkins University,9060,876,0,576,219,38,0,9,2,179.0,120,5381,2803,4269,0.024770953512046168,0.04534606205250591,,0.015873015873015817,0.00037181632273664,0.06821646341463405,0.028922631959508394,8841,838,0,567,5379,2624,4149
2020-04-12,asturias,Asturias,John Hopkins University,2001,157,0,105,52,7,0,3,41,4.0,21,1410,434,884,0.0266803488968701,0.046666666666666634,,0.02941176470588225,0.02994886778670569,0.009302325581395321,0.024333719582850577,1949,150,0,102,1369,430,863
2020-04-12,galicia,Galicia,John Hopkins University,7494,284,0,275,158,10,0,8,105,43.0,38,6024,1186,2344,0.021537622682660906,0.03649635036496357,,0.029962546816479474,0.017739483020780433,0.037620297462817254,0.01647875108412844,7336,274,0,267,5919,1143,2306
2020-04-12,madrid,Madrid,John Hopkins University,53285,6423,0,1327,341,145,0,-5,-506,702.0,-191,21477,25385,11233,0.006440767603505648,0.023096527556546675,,-0.0037537537537537524,-0.02301778647136421,0.02844062715229101,-0.01671918767507008,52944,6278,0,1332,21983,24683,11424
2020-04-12,andalucia,Andalucía,John Hopkins University,10062,815,0,621,86,16,0,2,-59,129.0,43,7280,1967,4993,0.008620689655172376,0.020025031289111483,,0.003231017770597644,-0.008039242403597213,0.0701849836779107,0.008686868686868632,9976,799,0,619,7339,1838,4950
2020-04-12,castilla_y_leon,Castilla y León,John Hopkins University,12628,1263,0,423,510,42,0,5,324,144.0,120,7211,4154,6077,0.0420861528305001,0.03439803439803435,,0.011961722488038173,0.04704515754319738,0.03591022443890268,0.020144367970454935,12118,1221,0,418,6887,4010,5957
2020-04-12,ceuta,Ceuta,John Hopkins University,95,4,0,4,2,0,0,0,-1,3.0,0,71,20,9,0.021505376344086002,0.0,,0.0,-0.01388888888888884,0.17647058823529416,0.0,93,4,0,4,72,17,9
2020-04-12,aragon,Aragón,John Hopkins University,4187,464,0,274,117,14,0,2,91,12.0,37,2777,946,1938,0.028746928746928857,0.03111111111111109,,0.007352941176470562,0.033879374534623974,0.012847965738758127,0.01946344029458169,4070,450,0,272,2686,934,1901
2020-04-12,pais_vasco,País Vasco,John Hopkins University,10674,831,0,464,160,27,0,5,-26,159.0,75,4817,5026,5622,0.015217804831653137,0.033582089552238736,,0.01089324618736387,-0.005368573198430759,0.03266899527429623,0.013520822065981708,10514,804,0,459,4843,4867,5547
2020-04-12,la_rioja,La Rioja,John Hopkins University,3358,223,0,73,79,4,0,0,37,38.0,19,1677,1458,1141,0.024092711192436722,0.0182648401826484,,0.0,0.022560975609756007,0.026760563380281654,0.01693404634581097,3279,219,0,73,1640,1420,1122
2020-04-12,extremadura,Extremadura,John Hopkins University,2658,321,0,107,78,9,0,1,39,30.0,22,1826,511,1096,0.03023255813953485,0.028846153846153744,,0.009433962264151052,0.021824286513710156,0.06237006237006226,0.020484171322160183,2580,312,0,106,1787,481,1074
2020-04-12,cantabria,Cantabria,John Hopkins University,1777,117,0,75,25,7,0,0,-2,20.0,22,1343,317,827,0.014269406392694028,0.06363636363636371,,0.0,-0.0014869888475836923,0.06734006734006726,0.027329192546583947,1752,110,0,75,1345,297,805
2020-04-13,castilla-la_mancha,Castilla-La Mancha,John Hopkins University,14329,1714,0,486,275,88,0,11,-224.0,411.0,48,9672,2943,7830,0.019567382951472867,0.05412054120541199,,0.023157894736842044,-0.022635408245755828,0.16232227488151652,0.006168080185042335,14054,1626,0,475,9896,2532,7782
2020-04-13,navarra,Navarra,John Hopkins University,4150,249,0,124,58,10,0,0,13.0,35.0,12,3171,730,1705,0.014173998044965774,0.04184100418410042,,0.0,0.0041165294490184134,0.050359712230215736,0.007088009450679333,4092,239,0,124,3158,695,1693
2020-04-13,melilla,Melilla,John Hopkins University,101,2,0,3,0,0,0,0,,,0,81,18,43,0.0,0.0,,0.0,,,0.0,101,2,0,3,81,18,43
2020-04-13,canarias,Canarias,John Hopkins University,1958,102,0,147,14,6,0,2,-123.0,131.0,8,1267,589,771,0.007201646090535085,0.0625,,0.01379310344827589,-0.08848920863309351,0.2860262008733625,0.010484927916120546,1944,96,0,145,1390,458,763
2020-04-13,baleares,Baleares,John Hopkins University,1571,118,0,144,21,1,0,2,11.0,9.0,15,582,871,825,0.013548387096774084,0.008547008547008517,,0.014084507042253502,0.019264448336252293,0.010440835266821269,0.0185185185185186,1550,117,0,142,571,862,810
2020-04-13,murcia,Murcia,John Hopkins University,1393,106,0,96,6,5,0,2,-122.0,123.0,23,811,476,566,0.00432588320115368,0.04950495049504955,,0.02127659574468077,-0.13076098606645226,0.3484419263456091,0.0423572744014733,1387,101,0,94,933,353,543
2020-04-13,cataluna,Cataluña,John Hopkins University,35197,3201,0,2102,471,96,0,18,28.0,347.0,261,21609,10387,19224,0.01356332431031504,0.03091787439613536,,0.008637236084452882,0.0012974375608174604,0.034561752988047756,0.013763644992880852,34726,3105,0,2084,21581,10040,18963
2020-04-13,c_valenciana,C. Valenciana,John Hopkins University,9213,907,0,581,153,31,0,5,-144.0,266.0,128,5237,3069,4397,0.016887417218543144,0.035388127853881235,,0.00868055555555558,-0.026760825125441423,0.09489832322511593,0.02998360271726397,9060,876,0,576,5381,2803,4269
2020-04-13,asturias,Asturias,John Hopkins University,2030,165,0,109,29,8,0,4,-3.0,24.0,18,1407,458,902,0.01449275362318847,0.05095541401273884,,0.03809523809523818,-0.0021276595744680327,0.055299539170506895,0.020361990950226172,2001,157,0,105,1410,434,884
2020-04-13,galicia,Galicia,John Hopkins University,7597,290,0,280,103,6,0,5,43.0,54.0,59,6067,1240,2403,0.013744328796370331,0.021126760563380254,,0.018181818181818077,0.007138114209827462,0.045531197301855064,0.025170648464163836,7494,284,0,275,6024,1186,2344
2020-04-13,madrid,Madrid,John Hopkins University,54287,6568,0,1299,1002,145,0,-28,-5.0,862.0,-480,21472,26247,10753,0.018804541615839332,0.02257512066012768,,-0.02110022607385076,-0.00023280718908602616,0.03395706125664755,-0.042731238315677045,53285,6423,0,1327,21477,25385,11233
2020-04-13,andalucia,Andalucía,John Hopkins University,10169,836,0,631,107,21,0,10,21.0,65.0,61,7301,2032,5054,0.010634068773603733,0.025766871165644245,,0.016103059581320522,0.0028846153846153744,0.03304524656837815,0.012217103945523666,10062,815,0,621,7280,1967,4993
2020-04-13,castilla_y_leon,Castilla y León,John Hopkins University,13180,1299,0,432,552,36,0,9,404.0,112.0,98,7615,4266,6175,0.043712385175799895,0.028503562945368266,,0.02127659574468077,0.05602551657190413,0.02696196437168985,0.016126378147112153,12628,1263,0,423,7211,4154,6077
2020-04-13,ceuta,Ceuta,John Hopkins University,96,4,0,4,1,0,0,0,-1.0,2.0,0,70,22,9,0.010526315789473717,0.0,,0.0,-0.014084507042253502,0.10000000000000009,0.0,95,4,0,4,71,20,9
2020-04-13,aragon,Aragón,John Hopkins University,4245,492,0,280,58,28,0,6,13.0,17.0,28,2790,963,1966,0.013852400286601396,0.06034482758620685,,0.021897810218978186,0.004681310767014724,0.017970401691332016,0.014447884416924683,4187,464,0,274,2777,946,1938
2020-04-13,pais_vasco,País Vasco,John Hopkins University,10845,859,0,470,171,28,0,6,-24.0,167.0,57,4793,5193,5679,0.016020236087689765,0.03369434416365835,,0.012931034482758674,-0.004982354162341718,0.03322721846398724,0.010138740661686185,10674,831,0,464,4817,5026,5622
2020-04-13,la_rioja,La Rioja,John Hopkins University,3420,234,0,74,62,11,0,1,-10.0,61.0,11,1667,1519,1152,0.01846337105419882,0.049327354260089606,,0.013698630136986356,-0.005963029218843174,0.041838134430727036,0.009640666082383786,3358,223,0,73,1677,1458,1141
2020-04-13,extremadura,Extremadura,John Hopkins University,2684,334,0,107,26,13,0,0,-54.0,67.0,18,1772,578,1114,0.009781790820165615,0.04049844236760114,,0.0,-0.02957283680175249,0.13111545988258322,0.01642335766423364,2658,321,0,107,1826,511,1096
2020-04-13,cantabria,Cantabria,John Hopkins University,1796,120,0,76,19,3,0,1,10.0,6.0,26,1353,323,853,0.010692177827799743,0.02564102564102555,,0.01333333333333342,0.007446016381235987,0.018927444794952786,0.03143893591293834,1777,117,0,75,1343,317,827
2020-04-14,castilla-la_mancha,Castilla-La Mancha,John Hopkins University,14680,1755,0,495,351,41,0,9,255,55,66,9927,2998,7896,0.024495777793286377,0.02392065344224048,,0.0185185185185186,0.02636476426799006,0.01868841318382608,0.008429118773946254,14329,1714,0,486,9672,2943,7830
2020-04-14,navarra,Navarra,John Hopkins University,4246,252,0,124,96,3,0,0,15,78,26,3186,808,1731,0.023132530120481887,0.012048192771084265,,0.0,0.004730368968779652,0.10684931506849304,0.015249266862169986,4150,249,0,124,3171,730,1705
2020-04-14,melilla,Melilla,John Hopkins University,102,2,0,3,1,0,0,0,-5,6,0,76,24,43,0.00990099009900991,0.0,,0.0,-0.06172839506172845,0.33333333333333326,0.0,101,2,0,3,81,18,43
2020-04-14,canarias,Canarias,John Hopkins University,1975,104,0,152,17,2,0,5,-18,33,10,1249,622,781,0.008682328907047898,0.019607843137254832,,0.03401360544217691,-0.01420678768745065,0.05602716468590829,0.012970168612191912,1958,102,0,147,1267,589,771
2020-04-14,baleares,Baleares,John Hopkins University,1605,125,0,148,34,7,0,4,17,10,31,599,881,856,0.021642266072565253,0.05932203389830515,,0.02777777777777768,0.029209621993127044,0.01148105625717566,0.037575757575757596,1571,118,0,144,582,871,825
2020-04-14,murcia,Murcia,John Hopkins University,1400,109,0,97,7,3,0,1,-33,37,8,778,513,574,0.005025125628140614,0.028301886792452935,,0.01041666666666674,-0.04069050554870535,0.07773109243697474,0.014134275618374659,1393,106,0,96,811,476,566
2020-04-14,cataluna,Cataluña,John Hopkins University,36505,3453,0,2189,1308,252,0,87,-37,1093,1040,21572,11480,20264,0.03716225814700125,0.07872539831302716,,0.04138915318744063,-0.0017122495256606252,0.1052276884567247,0.054099042863087865,35197,3201,0,2102,21609,10387,19224
2020-04-14,c_valenciana,C. Valenciana,John Hopkins University,9424,945,0,588,211,38,0,7,-118,291,68,5119,3360,4465,0.022902420492781905,0.04189636163175314,,0.012048192771084265,-0.022531983960282553,0.09481915933528828,0.015465089833977652,9213,907,0,581,5237,3069,4397
2020-04-14,asturias,Asturias,John Hopkins University,2089,172,0,111,59,7,0,2,23,29,12,1430,487,914,0.029064039408867037,0.042424242424242475,,0.0183486238532109,0.016346837242359635,0.06331877729257651,0.013303769401330268,2030,165,0,109,1407,458,902
2020-04-14,galicia,Galicia,John Hopkins University,7708,299,0,282,111,9,0,2,44,58,68,6111,1298,2471,0.014611030670001357,0.03103448275862064,,0.0071428571428571175,0.007252348772045503,0.04677419354838719,0.028297960882230466,7597,290,0,280,6067,1240,2403
2020-04-14,madrid,Madrid,John Hopkins University,55398,6724,0,1244,1111,156,0,-55,-231,1186,-637,21241,27433,10116,0.02046530476909747,0.02375152253349566,,-0.04234026173979988,-0.010758196721311508,0.04518611650855342,-0.059239282060820186,54287,6568,0,1299,21472,26247,10753
2020-04-14,andalucia,Andalucía,John Hopkins University,10392,865,0,665,223,29,0,34,2,192,93,7303,2224,5147,0.021929393254007223,0.0346889952153111,,0.0538827258320127,0.00027393507738660006,0.09448818897637801,0.01840126632370409,10169,836,0,631,7301,2032,5054
2020-04-14,castilla_y_leon,Castilla y León,John Hopkins University,13697,1337,0,440,517,38,0,8,224,255,131,7839,4521,6306,0.0392261001517451,0.029253271747498033,,0.0185185185185186,0.029415627051871285,0.05977496483825595,0.021214574898785532,13180,1299,0,432,7615,4266,6175
2020-04-14,ceuta,Ceuta,John Hopkins University,98,4,0,4,2,0,0,0,-6,8,0,64,30,9,0.02083333333333326,0.0,,0.0,-0.08571428571428574,0.36363636363636354,0.0,96,4,0,4,70,22,9
2020-04-14,aragon,Aragón,John Hopkins University,4338,514,0,282,93,22,0,2,22,49,40,2812,1012,2006,0.021908127208480455,0.04471544715447151,,0.0071428571428571175,0.007885304659498216,0.05088265835929384,0.020345879959308144,4245,492,0,280,2790,963,1966
2020-04-14,pais_vasco,País Vasco,John Hopkins University,11014,902,0,471,169,43,0,1,-109,235,71,4684,5428,5750,0.015583218072844573,0.05005820721769494,,0.0021276595744681437,-0.022741498017942785,0.04525322549585975,0.012502201091741494,10845,859,0,470,4793,5193,5679
2020-04-14,la_rioja,La Rioja,John Hopkins University,3457,246,0,75,37,12,0,1,-41,66,30,1626,1585,1182,0.010818713450292394,0.05128205128205132,,0.013513513513513598,-0.024595080983803252,0.04344963791968404,0.02604166666666674,3420,234,0,74,1667,1519,1152
2020-04-14,extremadura,Extremadura,John Hopkins University,2762,342,0,107,78,8,0,0,33,37,41,1805,615,1155,0.029061102831594576,0.0239520958083832,,0.0,0.018623024830699775,0.06401384083044981,0.03680430879712748,2684,334,0,107,1772,578,1114
2020-04-14,cantabria,Cantabria,John Hopkins University,1823,132,0,76,27,12,0,0,-25,40,20,1328,363,873,0.015033407572383028,0.10000000000000009,,0.0,-0.018477457501847705,0.1238390092879258,0.023446658851113744,1796,120,0,76,1353,323,853
2020-04-15,castilla-la_mancha,Castilla-La Mancha,John Hopkins University,15151,1796,0,503,471,41,0,8,50,380,91,9977,3378,7987,0.03208446866485004,0.023361823361823353,,0.016161616161616266,0.005036768409388603,0.1267511674449633,0.01152482269503552,14680,1755,0,495,9927,2998,7896
2020-04-15,navarra,Navarra,John Hopkins University,4348,261,0,124,102,9,0,0,56,37,21,3242,845,1752,0.02402260951483748,0.03571428571428581,,0.0,0.017576898932831098,0.04579207920792072,0.0121317157712304,4246,252,0,124,3186,808,1731
2020-04-15,melilla,Melilla,John Hopkins University,103,2,0,3,1,0,0,0,-2,3,0,74,27,43,0.009803921568627416,0.0,,0.0,-0.02631578947368418,0.125,0.0,102,2,0,3,76,24,43
2020-04-15,canarias,Canarias,John Hopkins University,1988,107,0,156,13,3,0,4,-41,51,21,1208,673,802,0.00658227848101256,0.028846153846153744,,0.026315789473684292,-0.032826261008807034,0.08199356913183276,0.02688860435339313,1975,104,0,152,1249,622,781
2020-04-15,baleares,Baleares,John Hopkins University,1636,131,0,151,31,6,0,3,-12,37,15,587,918,871,0.019314641744548222,0.04800000000000004,,0.020270270270270174,-0.02003338898163609,0.041997729852440324,0.017523364485981352,1605,125,0,148,599,881,856
2020-04-15,murcia,Murcia,John Hopkins University,1416,111,0,97,16,2,0,0,11,3,1,789,516,575,0.011428571428571344,0.0183486238532109,,0.0,0.014138817480719768,0.005847953216374213,0.0017421602787457413,1400,109,0,97,778,513,574
2020-04-15,cataluna,Cataluña,John Hopkins University,37354,3618,0,2252,849,165,0,63,203,481,289,21775,11961,20553,0.023257088070127274,0.04778453518679404,,0.028780264961169477,0.009410346745781561,0.04189895470383265,0.014261744966443057,36505,3453,0,2189,21572,11480,20264
2020-04-15,c_valenciana,C. Valenciana,John Hopkins University,9615,972,0,625,191,27,0,37,-178,342,59,4941,3702,4524,0.02026740237691005,0.02857142857142847,,0.06292517006802711,-0.034772416487595215,0.10178571428571437,0.013213885778275536,9424,945,0,588,5119,3360,4465
2020-04-15,asturias,Asturias,John Hopkins University,2110,176,0,112,21,4,0,1,-18,35,13,1412,522,927,0.010052656773575919,0.023255813953488413,,0.009009009009008917,-0.012587412587412583,0.07186858316221767,0.01422319474835887,2089,172,0,111,1430,487,914
2020-04-15,galicia,Galicia,John Hopkins University,7873,310,0,282,165,11,0,0,69,85,23,6180,1383,2494,0.021406331084587338,0.03678929765886285,,0.0,0.011291114383897849,0.06548536209553157,0.009307972480776971,7708,299,0,282,6111,1298,2471
2020-04-15,madrid,Madrid,John Hopkins University,56304,6877,0,1206,906,153,0,-38,-305,1058,-463,20936,28491,9653,0.01635438102458564,0.022754312908982666,,-0.030546623794212246,-0.014359022644884867,0.038566689753216865,-0.045769078687228126,55398,6724,0,1244,21241,27433,10116
2020-04-15,andalucia,Andalucía,John Hopkins University,10557,912,0,671,165,47,0,6,-292,410,79,7011,2634,5226,0.015877598152424843,0.054335260115606854,,0.009022556390977376,-0.039983568396549374,0.18435251798561159,0.01534874684282106,10392,865,0,665,7303,2224,5147
2020-04-15,castilla_y_leon,Castilla y León,John Hopkins University,14380,1372,0,445,683,35,0,5,444,204,143,8283,4725,6449,0.04986493392713731,0.02617801047120416,,0.011363636363636465,0.05663987753540001,0.04512276045122765,0.022676815731049738,13697,1337,0,440,7839,4521,6306
2020-04-15,ceuta,Ceuta,John Hopkins University,98,4,0,4,0,0,0,0,-11,11,0,53,41,9,0.0,0.0,,0.0,-0.171875,0.3666666666666667,0.0,98,4,0,4,64,30,9
2020-04-15,aragon,Aragón,John Hopkins University,4411,543,0,291,73,29,0,9,-31,75,102,2781,1087,2108,0.016828031350852868,0.05642023346303504,,0.03191489361702127,-0.01102418207681366,0.0741106719367588,0.05084745762711873,4338,514,0,282,2812,1012,2006
2020-04-15,pais_vasco,País Vasco,John Hopkins University,11203,956,0,478,189,54,0,7,-250,385,113,4434,5813,5863,0.017159978209551507,0.05986696230598665,,0.014861995753715496,-0.053373185311699434,0.07092851879145168,0.019652173913043525,11014,902,0,471,4684,5428,5750
2020-04-15,la_rioja,La Rioja,John Hopkins University,3539,257,0,75,82,11,0,0,2,69,25,1628,1654,1207,0.02371998842927403,0.04471544715447151,,0.0,0.0012300123001229846,0.043533123028391074,0.021150592216581998,3457,246,0,75,1626,1585,1182
2020-04-15,extremadura,Extremadura,John Hopkins University,2762,359,0,107,0,17,0,0,-51,34,31,1754,649,1186,0.0,0.04970760233918137,,0.0,-0.028254847645429404,0.055284552845528356,0.026839826839826886,2762,342,0,107,1805,615,1155
2020-04-15,cantabria,Cantabria,John Hopkins University,1845,137,0,77,22,5,0,1,-62,79,17,1266,442,890,0.012068019747668579,0.037878787878787845,,0.013157894736842035,-0.04668674698795183,0.21763085399449045,0.019473081328751363,1823,132,0,76,1328,363,873
2020-04-16,castilla-la_mancha,Castilla-La Mancha,John Hopkins University,15997,1852,0,511,846,56,0,8,568,222,31,10545,3600,8018,0.05583789848854859,0.031180400890868487,,0.015904572564612307,0.05693094116467878,0.06571936056838368,0.0038813071240766384,15151,1796,0,503,9977,3378,7987
2020-04-16,navarra,Navarra,John Hopkins University,4433,338,0,124,85,77,0,0,-39,47,29,3203,892,1781,0.019549218031278848,0.29501915708812265,,0.0,-0.012029611351017877,0.0556213017751479,0.016552511415525162,4348,261,0,124,3242,845,1752
2020-04-16,melilla,Melilla,John Hopkins University,104,2,0,3,1,0,0,0,-2,3,1,72,30,44,0.009708737864077666,0.0,,0.0,-0.027027027027026973,0.11111111111111116,0.023255813953488413,103,2,0,3,74,27,43
2020-04-16,canarias,Canarias,John Hopkins University,2009,111,0,159,21,4,0,3,-40,57,9,1168,730,811,0.010563380281690238,0.03738317757009346,,0.019230769230769162,-0.0331125827814569,0.0846953937592867,0.01122194513715713,1988,107,0,156,1208,673,802
2020-04-16,baleares,Baleares,John Hopkins University,1667,134,0,151,31,3,0,0,8,20,33,595,938,904,0.018948655256723734,0.022900763358778553,,0.0,0.013628620102214661,0.02178649237472774,0.03788748564867972,1636,131,0,151,587,918,871
2020-04-16,murcia,Murcia,John Hopkins University,1424,112,0,99,8,1,0,2,-22,29,10,767,545,585,0.005649717514124353,0.009009009009008917,,0.020618556701030855,-0.027883396704689534,0.056201550387597,0.017391304347825987,1416,111,0,97,789,516,575
2020-04-16,cataluna,Cataluña,John Hopkins University,38316,3752,0,2305,962,134,0,53,2,826,689,21777,12787,21242,0.025753600685334943,0.03703703703703698,,0.023534635879218557,9.184845005738573e-05,0.06905777108937383,0.033523086654016376,37354,3618,0,2252,21775,11961,20553
2020-04-16,c_valenciana,C. Valenciana,John Hopkins University,9615,999,0,632,0,27,0,7,-349,322,81,4592,4024,4605,0.0,0.02777777777777768,,0.011200000000000099,-0.07063347500505968,0.08698001080497031,0.017904509283819703,9615,972,0,625,4941,3702,4524
2020-04-16,asturias,Asturias,John Hopkins University,2163,186,0,113,53,10,0,1,20,23,39,1432,545,966,0.025118483412322368,0.05681818181818188,,0.008928571428571397,0.014164305949008416,0.044061302681992265,0.04207119741100329,2110,176,0,112,1412,522,927
2020-04-16,galicia,Galicia,John Hopkins University,8013,320,0,290,140,10,0,8,57,73,41,6237,1456,2535,0.017782293915915126,0.032258064516129004,,0.028368794326241176,0.00922330097087376,0.052783803326102774,0.01643945469125896,7873,310,0,282,6180,1383,2494
2020-04-16,madrid,Madrid,John Hopkins University,57157,7007,0,1154,853,130,0,-52,-222,945,-512,20714,29436,9141,0.015149900539926042,0.018903591682419618,,-0.04311774461028195,-0.010603744745892207,0.03316836895861841,-0.05304050554231843,56304,6877,0,1206,20936,28491,9653
2020-04-16,andalucia,Andalucía,John Hopkins University,10635,940,0,675,78,28,0,4,-106,156,72,6905,2790,5298,0.007388462631429338,0.030701754385964897,,0.005961251862891315,-0.01511909855940663,0.059225512528473745,0.013777267508610747,10557,912,0,671,7011,2634,5226
2020-04-16,castilla_y_leon,Castilla y León,John Hopkins University,14903,1401,0,449,523,29,0,4,295,199,69,8578,4924,6518,0.036369958275382475,0.021137026239067103,,0.008988764044943753,0.035615115296390165,0.04211640211640222,0.010699333229958086,14380,1372,0,445,8283,4725,6449
2020-04-16,ceuta,Ceuta,John Hopkins University,98,4,0,4,0,0,0,0,-3,3,0,50,44,9,0.0,0.0,,0.0,-0.05660377358490565,0.07317073170731714,0.0,98,4,0,4,53,41,9
2020-04-16,aragon,Aragón,John Hopkins University,4489,562,0,240,78,19,0,-51,25,34,43,2806,1121,2151,0.017683065064611148,0.03499079189686927,,-0.17525773195876293,0.008989572096368192,0.03127874885004589,0.020398481973434635,4411,543,0,291,2781,1087,2108
2020-04-16,pais_vasco,País Vasco,John Hopkins University,11403,992,0,484,200,36,0,6,-167,331,76,4267,6144,5939,0.017852360974738968,0.03765690376569042,,0.012552301255230214,-0.03766350924672979,0.05694133837949433,0.012962647108988534,11203,956,0,478,4434,5813,5863
2020-04-16,la_rioja,La Rioja,John Hopkins University,3547,262,0,76,8,5,0,1,-72,75,19,1556,1729,1226,0.002260525572195471,0.01945525291828787,,0.01333333333333342,-0.04422604422604426,0.0453446191051996,0.0157415078707539,3539,257,0,75,1628,1654,1207
2020-04-16,extremadura,Extremadura,John Hopkins University,2656,372,0,107,75,13,0,0,4,58,26,1577,707,1212,0.02905850445563729,0.0362116991643453,,0.0,0.002542911633820699,0.08936825885978439,0.021922428330522825,2581,359,0,107,1573,649,1186
2020-04-16,cantabria,Cantabria,John Hopkins University,1884,144,0,78,39,7,0,1,-36,68,13,1230,510,903,0.021138211382113914,0.051094890510948954,,0.01298701298701288,-0.028436018957345932,0.15384615384615374,0.014606741573033766,1845,137,0,77,1266,442,890
2020-04-17,castilla-la_mancha,Castilla-La Mancha,John Hopkins University,16349,1913,0,514,352,61,0,3,53.0,238.0,75,10598,3838,8093,0.022004125773582572,0.032937365010799136,,0.005870841487279899,0.00502607871028915,0.06611111111111101,0.009353953604390064,15997,1852,0,511,10545,3600,8018
2020-04-17,navarra,Navarra,John Hopkins University,4433,354,0,127,0,16,0,3,-78.0,62.0,48,3125,954,1829,0.0,0.047337278106508895,,0.024193548387096753,-0.024352169840774263,0.06950672645739919,0.02695115103874235,4433,338,0,124,3203,892,1781
2020-04-17,melilla,Melilla,John Hopkins University,104,2,0,3,0,0,0,0,,,0,72,30,44,0.0,0.0,,0.0,,,0.0,104,2,0,3,72,30,44
2020-04-17,canarias,Canarias,John Hopkins University,2035,115,0,160,26,4,0,1,-33.0,55.0,11,1135,785,822,0.012941762070681984,0.03603603603603611,,0.0062893081761006275,-0.02825342465753422,0.07534246575342474,0.013563501849568338,2009,111,0,159,1168,730,811
2020-04-17,baleares,Baleares,John Hopkins University,1723,148,0,156,56,14,0,5,22.0,20.0,32,617,958,936,0.033593281343731185,0.10447761194029859,,0.0331125827814569,0.03697478991596648,0.021321961620469176,0.03539823008849563,1667,134,0,151,595,938,904
2020-04-17,murcia,Murcia,John Hopkins University,1430,115,0,102,6,3,0,3,-90.0,93.0,26,677,638,611,0.004213483146067398,0.02678571428571419,,0.030303030303030276,-0.1173402868318123,0.17064220183486234,0.04444444444444451,1424,112,0,99,767,545,585
2020-04-17,cataluna,Cataluña,John Hopkins University,39943,3879,0,2349,1627,127,0,44,1012.0,488.0,771,22789,13275,22013,0.04246267877649035,0.03384861407249473,,0.019088937093275415,0.04647104743536756,0.03816376006881983,0.036296017324169094,38316,3752,0,2305,21777,12787,21242
2020-04-17,c_valenciana,C. Valenciana,John Hopkins University,9584,1042,0,636,98,43,0,4,-227.0,282.0,103,4236,4306,4708,0.010331014126080618,0.04304304304304307,,0.006329113924050667,-0.05086264844275157,0.07007952286282304,0.022366992399565744,9486,999,0,632,4463,4024,4605
2020-04-17,asturias,Asturias,John Hopkins University,2186,190,0,113,23,4,0,0,-11.0,30.0,14,1421,575,980,0.010633379565418322,0.021505376344086002,,0.0,-0.007681564245810013,0.05504587155963292,0.01449275362318847,2163,186,0,113,1432,545,966
2020-04-17,galicia,Galicia,John Hopkins University,8084,334,0,291,71,14,0,1,6.0,51.0,19,6243,1507,2554,0.00886060152252588,0.043749999999999956,,0.0034482758620688614,0.0009620009620010528,0.035027472527472625,0.007495069033530477,8013,320,0,290,6237,1456,2535
2020-04-17,madrid,Madrid,John Hopkins University,57978,7132,0,1094,821,125,0,-60,-343.0,1039.0,-544,20371,30475,8597,0.014363944923631466,0.017839303553589314,,-0.051993067590987874,-0.016558849087573657,0.035296915341758384,-0.059512088392954854,57157,7007,0,1154,20714,29436,9141
2020-04-17,andalucia,Andalucía,John Hopkins University,10734,967,0,677,99,27,0,2,-86.0,158.0,43,6819,2948,5341,0.009308885754583995,0.02872340425531905,,0.002962962962963056,-0.012454742939898678,0.05663082437275979,0.008116270290675631,10635,940,0,675,6905,2790,5298
2020-04-17,castilla_y_leon,Castilla y León,John Hopkins University,15293,1429,0,495,390,28,0,46,183.0,179.0,313,8761,5103,6831,0.026169227672280693,0.019985724482512568,,0.10244988864142535,0.021333644206108726,0.036352558895207165,0.048020865296103166,14903,1401,0,449,8578,4924,6518
2020-04-17,ceuta,Ceuta,John Hopkins University,100,4,0,4,2,0,0,0,-7.0,9.0,0,43,53,9,0.020408163265306145,0.0,,0.0,-0.14,0.20454545454545459,0.0,98,4,0,4,50,44,9
2020-04-17,aragon,Aragón,John Hopkins University,4551,601,0,243,62,39,0,3,23.0,,29,2829,1121,2180,0.013811539318333788,0.06939501779359425,,0.012499999999999956,0.008196721311475308,,0.01348210134821004,4489,562,0,240,2806,1121,2151
2020-04-17,pais_vasco,País Vasco,John Hopkins University,11553,1020,0,490,150,28,0,6,-290.0,412.0,91,3977,6556,6030,0.01315443304393571,0.02822580645161299,,0.012396694214876103,-0.06796344035622215,0.06705729166666674,0.015322444856036288,11403,992,0,484,4267,6144,5939
2020-04-17,la_rioja,La Rioja,John Hopkins University,3583,272,0,78,36,10,0,2,-22.0,48.0,23,1534,1777,1249,0.010149422046800138,0.03816793893129766,,0.026315789473684292,-0.014138817480719768,0.0277617119722382,0.018760195758564358,3547,262,0,76,1556,1729,1226
2020-04-17,extremadura,Extremadura,John Hopkins University,2663,380,0,107,7,8,0,0,-30.0,29.0,28,1547,736,1240,0.002635542168674787,0.021505376344086002,,0.0,-0.019023462270133185,0.04101838755304099,0.02310231023102305,2656,372,0,107,1577,707,1212
2020-04-17,cantabria,Cantabria,John Hopkins University,1990,149,0,78,106,5,0,0,77.0,24.0,8,1307,534,911,0.056263269639065916,0.03472222222222232,,0.0,0.06260162601626007,0.04705882352941182,0.008859357696566983,1884,144,0,78,1230,510,903
2020-04-18,castilla-la_mancha,Castilla-La Mancha,John Hopkins University,16349,1963,0,518,0,50,0,4,-175,125,44,10423,3963,8137,0.0,0.026136957658128512,,0.0077821011673151474,-0.01651254953764858,0.03256904637832214,0.005436797232176049,16349,1913,0,514,10598,3838,8093
2020-04-18,navarra,Navarra,John Hopkins University,4413,369,0,127,64,15,0,0,11,38,14,3052,992,1843,0.014716026672798366,0.04237288135593231,,0.0,0.0036172311739559593,0.0398322851153039,0.007654455986878084,4349,354,0,127,3041,954,1829
2020-04-18,melilla,Melilla,John Hopkins University,104,2,0,3,0,0,0,0,-14,14,0,58,44,44,0.0,0.0,,0.0,-0.19444444444444442,0.46666666666666656,0.0,104,2,0,3,72,30,44
2020-04-18,canarias,Canarias,John Hopkins University,2047,119,0,162,12,4,0,2,4,4,3,1139,789,825,0.005896805896805857,0.034782608695652195,,0.012499999999999956,0.0035242290748898064,0.005095541401273884,0.0036496350364962904,2035,115,0,160,1135,785,822
2020-04-18,baleares,Baleares,John Hopkins University,1739,155,0,159,16,7,0,3,-26,35,18,591,993,954,0.009286128845037656,0.04729729729729737,,0.019230769230769162,-0.04213938411669371,0.03653444676409179,0.019230769230769162,1723,148,0,156,617,958,936
2020-04-18,murcia,Murcia,John Hopkins University,1438,116,0,102,8,1,0,0,-7,14,1,670,652,612,0.005594405594405494,0.008695652173912993,,0.0,-0.010339734121122546,0.021943573667711602,0.0016366612111293755,1430,115,0,102,677,638,611
2020-04-18,cataluna,Cataluña,John Hopkins University,40448,3933,0,2395,505,54,0,46,35,416,222,22824,13691,22235,0.012643016298224952,0.0139211136890951,,0.019582801191996513,0.0015358286892799278,0.031337099811675984,0.010084949802389387,39943,3879,0,2349,22789,13275,22013
2020-04-18,c_valenciana,C. Valenciana,John Hopkins University,9657,1065,0,643,73,23,0,7,-191,241,73,4045,4547,4781,0.007616861435726152,0.02207293666026877,,0.011006289308176154,-0.04508970727101036,0.055968416163492796,0.015505522514868364,9584,1042,0,636,4236,4306,4708
2020-04-18,asturias,Asturias,John Hopkins University,2203,197,0,114,17,7,0,1,-11,21,8,1410,596,988,0.007776761207685334,0.03684210526315779,,0.008849557522123908,-0.007741027445460902,0.03652173913043488,0.008163265306122547,2186,190,0,113,1421,575,980
2020-04-18,galicia,Galicia,John Hopkins University,8185,346,0,294,101,12,0,3,60,29,36,6303,1536,2590,0.012493814943097536,0.03592814371257491,,0.010309278350515427,0.009610764055742349,0.01924353019243541,0.014095536413469167,8084,334,0,291,6243,1507,2554
2020-04-18,madrid,Madrid,John Hopkins University,58466,7239,0,1123,488,107,0,29,-457,838,-306,19914,31313,8291,0.00841698575321681,0.01500280426247902,,0.026508226691042136,-0.022433852044573155,0.027497949138638234,-0.035593811794812136,57978,7132,0,1094,20371,30475,8597
2020-04-18,andalucia,Andalucía,John Hopkins University,10898,993,0,687,164,26,0,10,-30,168,83,6789,3116,5424,0.015278554127072796,0.026887280248190315,,0.01477104874446078,-0.00439947206335245,0.056987788331071876,0.015540161018535947,10734,967,0,677,6819,2948,5341
2020-04-18,castilla_y_leon,Castilla y León,John Hopkins University,15293,1458,0,498,0,29,0,3,-188,159,150,8573,5262,6981,0.0,0.020293911826452016,,0.0060606060606061,-0.021458737587033427,0.031158142269253286,0.02195871761089152,15293,1429,0,495,8761,5103,6831
2020-04-18,ceuta,Ceuta,John Hopkins University,100,4,0,4,0,0,0,0,-6,6,0,37,59,9,0.0,0.0,,0.0,-0.13953488372093026,0.1132075471698113,0.0,100,4,0,4,43,53,9
2020-04-18,aragon,Aragón,John Hopkins University,4608,619,0,246,57,18,0,3,-15,54,36,2814,1175,2216,0.012524719841793042,0.029950083194675514,,0.012345679012345734,-0.005302226935312793,0.04817127564674406,0.016513761467889854,4551,601,0,243,2829,1121,2180
2020-04-18,pais_vasco,País Vasco,John Hopkins University,11731,1062,0,499,178,42,0,9,-280,416,56,3697,6972,6086,0.015407253527222275,0.04117647058823537,,0.01836734693877551,-0.07040482775961776,0.06345332519829161,0.009286898839137692,11553,1020,0,490,3977,6556,6030
2020-04-18,la_rioja,La Rioja,John Hopkins University,3636,277,0,79,53,5,0,1,9,39,19,1543,1816,1268,0.014792073681272777,0.018382352941176405,,0.012820512820512775,0.005867014341590648,0.0219471018570625,0.015212169735788539,3583,272,0,78,1534,1777,1249
2020-04-18,extremadura,Extremadura,John Hopkins University,2673,384,0,107,10,4,0,0,-25,31,38,1522,767,1278,0.0037551633496057946,0.010526315789473717,,0.0,-0.01616031027795739,0.04211956521739135,0.030645161290322687,2663,380,0,107,1547,736,1240
2020-04-18,cantabria,Cantabria,John Hopkins University,1990,153,0,78,0,4,0,0,-80,76,13,1227,610,924,0.0,0.02684563758389258,,0.0,-0.06120887528691665,0.14232209737827706,0.014270032930845167,1990,149,0,78,1307,534,911
2020-04-19,castilla-la_mancha,Castilla-La Mancha,John Hopkins University,14725,2021,0,531,137,58,0,13,-136,215,36,8526,4178,8173,0.009391280504524202,0.02954661232806921,,0.025096525096525157,-0.015700761948741593,0.05425182942215501,0.0044242349760355015,14588,1963,0,518,8662,3963,8137
2020-04-19,navarra,Navarra,John Hopkins University,4449,385,0,128,36,16,0,1,-111,131,13,2941,1123,1856,0.008157715839564927,0.04336043360433606,,0.007874015748031482,-0.036369593709043246,0.13205645161290325,0.007053716766142193,4413,369,0,127,3052,992,1843
2020-04-19,melilla,Melilla,John Hopkins University,104,2,0,3,0,0,0,0,-2,2,0,56,46,44,0.0,0.0,,0.0,-0.03448275862068961,0.045454545454545414,0.0,104,2,0,3,58,44,44
2020-04-19,canarias,Canarias,John Hopkins University,2067,119,0,163,20,0,0,1,-4,24,1,1135,813,826,0.009770395701026002,0.0,,0.006172839506172867,-0.0035118525021948788,0.03041825095057038,0.00121212121212122,2047,119,0,162,1139,789,825
2020-04-19,baleares,Baleares,John Hopkins University,1748,157,0,160,9,2,0,1,-5,12,8,586,1005,962,0.005175388154111449,0.012903225806451646,,0.0062893081761006275,-0.008460236886632777,0.012084592145015005,0.008385744234800763,1739,155,0,159,591,993,954
2020-04-19,murcia,Murcia,John Hopkins University,1440,117,0,103,2,1,0,1,-9,10,0,661,662,612,0.0013908205841446364,0.008620689655172376,,0.009803921568627416,-0.013432835820895495,0.015337423312883347,0.0,1438,116,0,102,670,652,612
2020-04-19,cataluna,Cataluña,John Hopkins University,41676,4009,0,2409,1228,76,0,14,909,243,140,23733,13934,22375,0.030359968354430444,0.019323671497584627,,0.0058455114822546506,0.03982649842271302,0.01774888612957426,0.006296379581740563,40448,3933,0,2395,22824,13691,22235
2020-04-19,c_valenciana,C. Valenciana,John Hopkins University,9708,1079,0,646,51,14,0,3,-45,82,46,4000,4629,4827,0.0052811432121777635,0.013145539906103343,,0.004665629860031162,-0.011124845488257096,0.01803386848471522,0.009621418113365365,9657,1065,0,643,4045,4547,4781
2020-04-19,asturias,Asturias,John Hopkins University,2213,199,0,115,10,2,0,1,5,3,5,1415,599,993,0.00453926463912846,0.010152284263959421,,0.00877192982456143,0.0035460992907800915,0.005033557046979942,0.005060728744939347,2203,197,0,114,1410,596,988
2020-04-19,galicia,Galicia,John Hopkins University,8299,352,0,296,114,6,0,2,96,12,19,6399,1548,2609,0.013927916921197214,0.01734104046242768,,0.006802721088435382,0.015230842455973281,0.0078125,0.007335907335907388,8185,346,0,294,6303,1536,2590
2020-04-19,madrid,Madrid,John Hopkins University,58673,7351,0,1111,207,112,0,-12,-354,449,-100,19560,31762,8191,0.003540519276160614,0.015471750241746074,,-0.010685663401602818,-0.01777643868635126,0.01433909238974218,-0.012061271257990613,58466,7239,0,1123,19914,31313,8291
2020-04-19,andalucia,Andalucía,John Hopkins University,10991,1013,0,690,93,20,0,3,-40,113,49,6749,3229,5473,0.00853367590383547,0.020140986908358416,,0.004366812227074135,-0.005891883929886599,0.036264441591784324,0.00903392330383479,10898,993,0,687,6789,3116,5424
2020-04-19,castilla_y_leon,Castilla y León,John Hopkins University,14781,1493,0,501,137,35,0,3,-2,104,99,7922,5366,7080,0.0093553673859601,0.02400548696844984,,0.006024096385542244,-0.00025239777889951576,0.019764348156594558,0.014181349376880092,14644,1458,0,498,7924,5262,6981
2020-04-19,ceuta,Ceuta,John Hopkins University,100,4,0,4,0,0,0,0,-15,15,0,22,74,9,0.0,0.0,,0.0,-0.4054054054054054,0.2542372881355932,0.0,100,4,0,4,37,59,9
2020-04-19,aragon,Aragón,John Hopkins University,4654,637,0,248,46,18,0,2,25,3,28,2839,1178,2244,0.00998263888888884,0.029079159935379684,,0.008130081300812941,0.008884150675195546,0.002553191489361728,0.012635379061371799,4608,619,0,246,2814,1175,2216
2020-04-19,pais_vasco,País Vasco,John Hopkins University,11789,1081,0,501,58,19,0,2,-113,152,23,3584,7124,6109,0.004944165032819026,0.01789077212806034,,0.004008016032064132,-0.030565323235055453,0.021801491681009644,0.0037791652974039636,11731,1062,0,499,3697,6972,6086
2020-04-19,la_rioja,La Rioja,John Hopkins University,3664,285,0,79,28,8,0,0,3,17,14,1546,1833,1282,0.007700770077007757,0.028880866425992746,,0.0,0.0019442644199612058,0.009361233480176256,0.011041009463722329,3636,277,0,79,1543,1816,1268
2020-04-19,extremadura,Extremadura,John Hopkins University,2692,389,0,107,19,5,0,0,-77,91,28,1445,858,1306,0.007108118219229409,0.01302083333333326,,0.0,-0.050591327201051195,0.11864406779661008,0.021909233176838905,2673,384,0,107,1522,767,1278
2020-04-19,cantabria,Cantabria,John Hopkins University,1973,158,0,78,24,5,0,0,3,16,10,1189,626,934,0.012314007183170883,0.03267973856209161,,0.0,0.002529510961214232,0.026229508196721207,0.010822510822510845,1949,153,0,78,1186,610,924
2020-04-20,castilla-la_mancha,Castilla-La Mancha,John Hopkins University,14936,2075,0,534,211,54,0,3,93.0,64.0,26,8619,4242,8199,0.014329371816638403,0.02671944581890151,,0.005649717514124353,0.010907811400422185,0.015318334131163347,0.0031812064113545535,14725,2021,0,531,8526,4178,8173
2020-04-20,navarra,Navarra,John Hopkins University,4475,397,0,128,26,12,0,0,-53.0,67.0,21,2888,1190,1877,0.005844009889862889,0.03116883116883118,,0.0,-0.018021081264875893,0.05966162065894931,0.011314655172413701,4449,385,0,128,2941,1123,1856
2020-04-20,melilla,Melilla,John Hopkins University,105,2,0,3,1,0,0,0,1.0,,0,57,46,44,0.009615384615384581,0.0,,0.0,0.017857142857142794,,0.0,104,2,0,3,56,46,44
2020-04-20,canarias,Canarias,John Hopkins University,2085,120,0,164,18,1,0,1,-48.0,65.0,11,1087,878,837,0.00870827285921627,0.008403361344537785,,0.006134969325153339,-0.042290748898678454,0.07995079950799511,0.013317191283293006,2067,119,0,163,1135,813,826
2020-04-20,baleares,Baleares,John Hopkins University,1766,161,0,160,18,4,0,0,14.0,,23,600,1005,985,0.010297482837528626,0.02547770700636942,,0.0,0.023890784982935065,,0.023908523908523938,1748,157,0,160,586,1005,962
2020-04-20,murcia,Murcia,John Hopkins University,1445,120,0,104,5,3,0,1,-38.0,40.0,2,623,702,614,0.003472222222222321,0.02564102564102555,,0.009708737864077666,-0.05748865355521937,0.06042296072507547,0.0032679738562091387,1440,117,0,103,661,662,612
2020-04-20,cataluna,Cataluña,John Hopkins University,43112,4152,0,2437,1436,143,0,28,781.0,512.0,421,24514,14446,22796,0.03445628179287841,0.035669743078074356,,0.0116230801162307,0.03290776555850505,0.03674465336586774,0.018815642458100523,41676,4009,0,2409,23733,13934,22375
2020-04-20,c_valenciana,C. Valenciana,John Hopkins University,9750,1089,0,648,42,10,0,2,-58.0,90.0,39,3942,4719,4866,0.004326328800988932,0.009267840593141896,,0.003095975232198178,-0.014499999999999957,0.01944264419961117,0.00807955251709136,9708,1079,0,646,4000,4629,4827
2020-04-20,asturias,Asturias,John Hopkins University,2220,203,0,116,7,4,0,1,-14.0,17.0,6,1401,616,999,0.0031631269769543113,0.0201005025125629,,0.008695652173912993,-0.009893992932862195,0.028380634390651194,0.0060422960725075026,2213,199,0,115,1415,599,993
2020-04-20,galicia,Galicia,John Hopkins University,8468,360,0,296,169,8,0,0,121.0,40.0,43,6520,1588,2652,0.02036389926497173,0.022727272727272707,,0.0,0.0189092045632131,0.025839793281653645,0.01648141050210805,8299,352,0,296,6399,1548,2609
2020-04-20,madrid,Madrid,John Hopkins University,59300,7460,0,1076,627,109,0,-35,3.0,515.0,-261,19563,32277,7930,0.010686346360336163,0.014827914569446321,,-0.03150315031503148,0.00015337423312877796,0.016214344184874996,-0.03186424124038578,58673,7351,0,1111,19560,31762,8191
2020-04-20,andalucia,Andalucía,John Hopkins University,11095,1017,0,692,104,4,0,2,-82.0,182.0,36,6667,3411,5509,0.009462287325993968,0.003948667324777944,,0.0028985507246377384,-0.012149948140465217,0.05636419944255189,0.006577745295085036,10991,1013,0,690,6749,3229,5473
2020-04-20,castilla_y_leon,Castilla y León,John Hopkins University,14951,1521,0,503,170,28,0,2,79.0,63.0,94,8001,5429,7174,0.011501251606792495,0.018754186202277312,,0.003992015968063978,0.009972229235041707,0.011740588893030202,0.013276836158192085,14781,1493,0,501,7922,5366,7080
2020-04-20,ceuta,Ceuta,John Hopkins University,100,4,0,4,0,0,0,0,,,0,22,74,9,0.0,0.0,,0.0,,,0.0,100,4,0,4,22,74,9
2020-04-20,aragon,Aragón,John Hopkins University,4684,643,0,250,30,6,0,2,20.0,4.0,27,2859,1182,2271,0.00644606789858182,0.009419152276295195,,0.008064516129032251,0.007044734061289137,0.00339558573853993,0.012032085561497263,4654,637,0,248,2839,1178,2244
2020-04-20,pais_vasco,País Vasco,John Hopkins University,11843,1103,0,507,54,22,0,6,-121.0,153.0,32,3463,7277,6141,0.004580541182458209,0.020351526364477346,,0.011976047904191711,-0.0337611607142857,0.021476698483997803,0.0052381731871009585,11789,1081,0,501,3584,7124,6109
2020-04-20,la_rioja,La Rioja,John Hopkins University,3684,294,0,81,20,9,0,2,-22.0,33.0,15,1524,1866,1297,0.005458515283842891,0.03157894736842115,,0.025316455696202445,-0.014230271668822736,0.018003273322422242,0.011700468018720711,3664,285,0,79,1546,1833,1282
2020-04-20,extremadura,Extremadura,John Hopkins University,2692,397,0,107,0,8,0,0,-71.0,63.0,21,1374,921,1327,0.0,0.020565552699228773,,0.0,-0.04913494809688579,0.07342657342657333,0.01607963246554367,2692,389,0,107,1445,858,1306
2020-04-20,cantabria,Cantabria,John Hopkins University,1998,165,0,78,25,7,0,0,-2.0,20.0,14,1187,646,948,0.012671059300557452,0.044303797468354444,,0.0,-0.001682085786375076,0.03194888178913735,0.01498929336188426,1973,158,0,78,1189,626,934
2020-04-21,castilla-la_mancha,Castilla-La Mancha,John Hopkins University,15053,2140,0,537,117,65,0,3,-43,95,44,8576,4337,8243,0.007833422603106488,0.031325301204819356,,0.00561797752808979,-0.004988977839656572,0.022395096652522373,0.005366508110745238,14936,2075,0,534,8619,4242,8199
2020-04-21,navarra,Navarra,John Hopkins University,4531,401,0,128,56,4,0,0,-74,126,17,2814,1316,1894,0.012513966480447003,0.010075566750629816,,0.0,-0.025623268698060975,0.10588235294117654,0.009057005860415579,4475,397,0,128,2888,1190,1877
2020-04-21,melilla,Melilla,John Hopkins University,105,2,0,3,0,0,0,0,-4,4,0,53,50,44,0.0,0.0,,0.0,-0.07017543859649122,0.08695652173913038,0.0,105,2,0,3,57,46,44
2020-04-21,canarias,Canarias,John Hopkins University,2094,121,0,164,9,1,0,0,-41,49,4,1046,927,841,0.004316546762589857,0.008333333333333304,,0.0,-0.03771849126034954,0.05580865603644658,0.004778972520907976,2085,120,0,164,1087,878,837
2020-04-21,baleares,Baleares,John Hopkins University,1786,164,0,165,20,3,0,5,5,12,19,605,1017,1004,0.011325028312570762,0.01863354037267073,,0.03125,0.008333333333333304,0.011940298507462588,0.019289340101522834,1766,161,0,160,600,1005,985
2020-04-21,murcia,Murcia,John Hopkins University,1455,123,0,104,10,3,0,0,-52,59,8,571,761,622,0.006920415224913601,0.02499999999999991,,0.0,-0.0834670947030498,0.08404558404558404,0.013029315960912058,1445,120,0,104,623,702,614
2020-04-21,cataluna,Cataluña,John Hopkins University,43802,4247,0,2460,690,95,0,23,-48,643,499,24466,15089,23295,0.01600482464279085,0.022880539499036567,,0.009437833401723328,-0.0019580647793098205,0.044510591167105096,0.021889805228987536,43112,4152,0,2437,24514,14446,22796
2020-04-21,c_valenciana,C. Valenciana,John Hopkins University,9825,1106,0,649,75,17,0,1,-234,292,30,3708,5011,4896,0.007692307692307665,0.015610651974288237,,0.0015432098765431057,-0.05936073059360736,0.06187751642297101,0.006165228113440113,9750,1089,0,648,3942,4719,4866
2020-04-21,asturias,Asturias,John Hopkins University,2230,211,0,116,10,8,0,0,-24,26,8,1377,642,1007,0.0045045045045044585,0.039408866995073843,,0.0,-0.017130620985010725,0.04220779220779214,0.00800800800800805,2220,203,0,116,1401,616,999
2020-04-21,galicia,Galicia,John Hopkins University,8634,368,0,297,166,8,0,1,121,37,22,6641,1625,2674,0.019603212092583755,0.022222222222222143,,0.0033783783783782884,0.018558282208589016,0.023299748110831242,0.008295625942684737,8468,360,0,296,6520,1588,2652
2020-04-21,madrid,Madrid,John Hopkins University,59950,7577,0,1024,650,117,0,-52,-222,755,-466,19341,33032,7464,0.010961214165261302,0.015683646112600647,,-0.048327137546468446,-0.011347952767980396,0.023391269324906316,-0.05876418663303906,59300,7460,0,1076,19563,32277,7930
2020-04-21,andalucia,Andalucía,John Hopkins University,11225,1050,0,696,130,33,0,4,-61,158,56,6606,3569,5565,0.011716989634970698,0.032448377581120846,,0.005780346820809301,-0.00914954252287381,0.0463207270595134,0.010165184243964509,11095,1017,0,692,6667,3411,5509
2020-04-21,castilla_y_leon,Castilla y León,John Hopkins University,15141,1554,0,505,190,33,0,2,-28,185,90,7973,5614,7264,0.012708180054845863,0.021696252465483346,,0.003976143141153132,-0.0034995625546806464,0.034076257137594324,0.01254530248118213,14951,1521,0,503,8001,5429,7174
2020-04-21,ceuta,Ceuta,John Hopkins University,100,4,0,4,0,0,0,0,-3,3,0,20,76,9,0.0,0.0,,0.0,-0.13043478260869568,0.041095890410958846,0.0,100,4,0,4,23,73,9
2020-04-21,aragon,Aragón,John Hopkins University,4761,656,0,252,77,13,0,2,-284,348,33,2575,1530,2304,0.01643894107600352,0.02021772939346822,,0.008000000000000007,-0.09933543196922001,0.29441624365482233,0.014531043593130732,4684,643,0,250,2859,1182,2271
2020-04-21,pais_vasco,País Vasco,John Hopkins University,11974,1124,0,513,131,21,0,6,-264,374,60,3199,7651,6201,0.011061386473022017,0.01903898458748876,,0.01183431952662728,-0.07623447877562806,0.051394805551738365,0.009770395701026002,11843,1103,0,507,3463,7277,6141
2020-04-21,la_rioja,La Rioja,John Hopkins University,3704,298,0,81,20,4,0,0,-17,33,21,1507,1899,1318,0.005428881650380024,0.013605442176870763,,0.0,-0.011154855643044637,0.01768488745980701,0.01619121048573624,3684,294,0,81,1524,1866,1297
2020-04-21,extremadura,Extremadura,John Hopkins University,2692,404,0,107,0,7,0,0,-137,130,22,1237,1051,1349,0.0,0.017632241813602123,,0.0,-0.09970887918486171,0.14115092290988063,0.016578749058025588,2692,397,0,107,1374,921,1327
2020-04-21,cantabria,Cantabria,John Hopkins University,2012,167,0,78,14,2,0,0,-60,72,8,1127,718,956,0.00700700700700696,0.0121212121212122,,0.0,-0.05054759898904804,0.11145510835913308,0.00843881856540074,1998,165,0,78,1187,646,948
2020-04-22,castilla-la_mancha,Castilla-La Mancha,John Hopkins University,15128,2188,0,546,75,48,0,9,-213.0,240.0,61,8363,4577,8304,0.0049823955357735095,0.02242990654205612,,0.016759776536312776,-0.02483675373134331,0.055337791099838496,0.007400218367099365,15053,2140,0,537,8576,4337,8243
2020-04-22,navarra,Navarra,John Hopkins University,4577,409,0,129,46,8,0,1,-91.0,129.0,13,2723,1445,1907,0.010152284263959421,0.01995012468827939,,0.0078125,-0.03233830845771146,0.09802431610942253,0.006863780359028571,4531,401,0,128,2814,1316,1894
2020-04-22,melilla,Melilla,John Hopkins University,106,2,0,3,1,0,0,0,-4.0,5.0,0,49,55,44,0.00952380952380949,0.0,,0.0,-0.07547169811320753,0.10000000000000009,0.0,105,2,0,3,53,50,44
2020-04-22,canarias,Canarias,John Hopkins University,2113,121,0,169,19,0,0,5,-23.0,42.0,14,1023,969,855,0.009073543457497557,0.0,,0.030487804878048808,-0.02198852772466542,0.0453074433656957,0.016646848989298357,2094,121,0,164,1046,927,841
2020-04-22,baleares,Baleares,John Hopkins University,1805,168,0,165,19,4,0,0,-15.0,30.0,17,590,1047,1021,0.010638297872340496,0.024390243902439046,,0.0,-0.024793388429752095,0.029498525073746285,0.016932270916334646,1786,164,0,165,605,1017,1004
2020-04-22,murcia,Murcia,John Hopkins University,1460,124,0,104,5,1,0,0,-1.0,5.0,2,570,766,624,0.0034364261168384758,0.008130081300812941,,0.0,-0.0017513134851138146,0.006570302233902758,0.003215434083601254,1455,123,0,104,571,761,622
2020-04-22,cataluna,Cataluña,John Hopkins University,44892,4343,0,2478,1090,96,0,18,606.0,388.0,352,25072,15477,23647,0.02488470846080082,0.022604191193783763,,0.007317073170731714,0.024769067277037538,0.025714096361587835,0.01511053874221946,43802,4247,0,2460,24466,15089,23295
2020-04-22,c_valenciana,C. Valenciana,John Hopkins University,9869,1124,0,650,44,18,0,1,-351.0,377.0,21,3357,5388,4917,0.004478371501272171,0.016274864376130127,,0.0015408320493066618,-0.09466019417475724,0.0752344841349033,0.004289215686274606,9825,1106,0,649,3708,5011,4896
2020-04-22,asturias,Asturias,John Hopkins University,2241,222,0,116,11,11,0,0,-23.0,23.0,2,1354,665,1009,0.004932735426008916,0.05213270142180093,,0.0,-0.016702977487291215,0.03582554517133962,0.0019860973187686426,2230,211,0,116,1377,642,1007
2020-04-22,galicia,Galicia,John Hopkins University,8805,375,0,298,171,7,0,1,113.0,51.0,20,6754,1676,2694,0.01980542043085487,0.01902173913043481,,0.0033670033670034627,0.01701550971239274,0.031384615384615344,0.007479431563201189,8634,368,0,297,6641,1625,2674
2020-04-22,madrid,Madrid,John Hopkins University,60657,7684,0,981,707,107,0,-43,-13.0,613.0,-387,19328,33645,7077,0.011793160967472849,0.014121684043816751,,-0.0419921875,-0.0006721472519518601,0.018557762170017034,-0.05184887459807075,59950,7577,0,1024,19341,33032,7464
2020-04-22,andalucia,Andalucía,John Hopkins University,11358,1079,0,702,133,29,0,6,-174.0,278.0,51,6432,3847,5616,0.011848552338530105,0.027619047619047654,,0.008620689655172376,-0.026339691189827374,0.077892967217708,0.009164420485175295,11225,1050,0,696,6606,3569,5565
2020-04-22,castilla_y_leon,Castilla y León,John Hopkins University,15510,1582,0,508,369,28,0,3,178.0,163.0,133,8151,5777,7397,0.02437091341390918,0.018018018018018056,,0.005940594059405946,0.02232534804966768,0.029034556465977968,0.018309471365638874,15141,1554,0,505,7973,5614,7264
2020-04-22,ceuta,Ceuta,John Hopkins University,100,4,0,4,0,0,0,0,,,0,20,76,9,0.0,0.0,,0.0,,,0.0,100,4,0,4,20,76,9
2020-04-22,aragon,Aragón,John Hopkins University,4833,681,0,253,72,25,0,1,-103.0,150.0,36,2472,1680,2340,0.01512287334593565,0.038109756097560954,,0.003968253968253954,-0.040000000000000036,0.0980392156862746,0.015625,4761,656,0,252,2575,1530,2304
2020-04-22,pais_vasco,País Vasco,John Hopkins University,12094,1167,0,516,120,43,0,3,-408.0,485.0,59,2791,8136,6260,0.010021713713044944,0.03825622775800719,,0.005847953216374213,-0.12753985620506403,0.0633904064828128,0.009514594420254818,11974,1124,0,513,3199,7651,6201
2020-04-22,la_rioja,La Rioja,John Hopkins University,3741,303,0,82,37,5,0,1,-6.0,38.0,13,1501,1937,1331,0.009989200863930847,0.016778523489932917,,0.012345679012345734,-0.003981420039814165,0.020010531858873026,0.009863429438543347,3704,298,0,81,1507,1899,1318
2020-04-22,extremadura,Extremadura,John Hopkins University,2715,407,0,107,23,3,0,0,-166.0,186.0,26,1071,1237,1375,0.008543833580980653,0.007425742574257432,,0.0,-0.1341956345998383,0.17697431018078014,0.01927353595255754,2692,404,0,107,1237,1051,1349
2020-04-22,cantabria,Cantabria,John Hopkins University,2023,173,0,78,11,6,0,0,-127.0,132.0,9,1000,850,965,0.005467196819085585,0.03592814371257491,,0.0,-0.11268855368234254,0.1838440111420614,0.009414225941422494,2012,167,0,78,1127,718,956
2020-04-23,castilla-la_mancha,Castilla-La Mancha,John Hopkins University,15365,2255,0,553,237,67,0,7,-35,205,38,8328,4782,8342,0.01566631411951347,0.03062157221206574,,0.012820512820512775,-0.004185101040296568,0.04478916320734094,0.004576107899807225,15128,2188,0,546,8363,4577,8304
2020-04-23,navarra,Navarra,John Hopkins University,4581,417,0,129,4,8,0,0,-111,107,8,2612,1552,1915,0.000873934891850503,0.019559902200489088,,0.0,-0.04076386338597138,0.07404844290657442,0.004195070791819688,4577,409,0,129,2723,1445,1907
2020-04-23,melilla,Melilla,John Hopkins University,107,2,0,3,1,0,0,0,-5,6,0,44,61,44,0.009433962264151052,0.0,,0.0,-0.10204081632653061,0.10909090909090913,0.0,106,2,0,3,49,55,44
2020-04-23,canarias,Canarias,John Hopkins University,2140,128,0,169,27,7,0,0,-28,48,13,995,1017,868,0.012778040700425874,0.05785123966942152,,0.0,-0.027370478983382185,0.049535603715170184,0.015204678362572999,2113,121,0,169,1023,969,855
2020-04-23,baleares,Baleares,John Hopkins University,1819,172,0,165,14,4,0,0,-24,34,18,566,1081,1039,0.007756232686980669,0.023809523809523725,,0.0,-0.04067796610169494,0.03247373447946522,0.01762977473065619,1805,168,0,165,590,1047,1021
2020-04-23,murcia,Murcia,John Hopkins University,1468,125,0,105,8,1,0,1,-18,25,1,552,791,625,0.005479452054794498,0.008064516129032251,,0.009615384615384581,-0.03157894736842104,0.03263707571801566,0.0016025641025640969,1460,124,0,104,570,766,624
2020-04-23,cataluna,Cataluña,John Hopkins University,45544,4393,0,2569,652,50,0,91,-59,661,483,25013,16138,24130,0.014523745878998406,0.011512779184895239,,0.03672316384180796,-0.0023532227185705246,0.04270853524584872,0.020425423943840615,44892,4343,0,2478,25072,15477,23647
2020-04-23,c_valenciana,C. Valenciana,John Hopkins University,9939,1147,0,651,70,23,0,1,-374,421,28,2983,5809,4945,0.007092917215523409,0.020462633451957313,,0.0015384615384614886,-0.11140899612749477,0.07813659985152199,0.005694529184462116,9869,1124,0,650,3357,5388,4917
2020-04-23,asturias,Asturias,John Hopkins University,2245,228,0,117,4,6,0,1,-25,23,3,1329,688,1012,0.0017849174475681462,0.027027027027026973,,0.008620689655172376,-0.01846381093057603,0.03458646616541361,0.0029732408325073845,2241,222,0,116,1354,665,1009
2020-04-23,galicia,Galicia,John Hopkins University,8932,382,0,301,127,7,0,3,66,54,13,6820,1730,2707,0.01442362294151045,0.01866666666666661,,0.010067114093959662,0.009771986970684043,0.03221957040572798,0.0048255382331106045,8805,375,0,298,6754,1676,2694
2020-04-23,madrid,Madrid,John Hopkins University,61099,7765,0,949,442,81,0,-32,-206,567,-476,19122,34212,6601,0.007286875381242064,0.010541384695471168,,-0.032619775739041845,-0.010658112582781487,0.016852429781542666,-0.06726013847675572,60657,7684,0,981,19328,33645,7077
2020-04-23,andalucia,Andalucía,John Hopkins University,11486,1107,0,714,128,28,0,12,-45,145,59,6387,3992,5675,0.011269589716499384,0.025949953660797,,0.017094017094017033,-0.006996268656716431,0.037691707824278664,0.010505698005698116,11358,1079,0,702,6432,3847,5616
2020-04-23,castilla_y_leon,Castilla y León,John Hopkins University,15692,1612,0,510,182,30,0,2,-14,166,109,8137,5943,7506,0.011734364925854335,0.01896333754740831,,0.003937007874015741,-0.0017175806649490921,0.02873463735502857,0.014735703663647515,15510,1582,0,508,8151,5777,7397
2020-04-23,ceuta,Ceuta,John Hopkins University,100,4,0,4,0,0,0,0,-8,8,1,12,84,10,0.0,0.0,,0.0,-0.4,0.10526315789473695,0.11111111111111116,100,4,0,4,20,76,9
2020-04-23,aragon,Aragón,John Hopkins University,4867,695,0,254,34,14,0,1,-81,101,19,2391,1781,2359,0.007034967928822633,0.0205580029368575,,0.0039525691699604515,-0.03276699029126218,0.06011904761904763,0.00811965811965809,4833,681,0,253,2472,1680,2340
2020-04-23,pais_vasco,País Vasco,John Hopkins University,12204,1193,0,518,110,26,0,2,-239,323,55,2552,8459,6315,0.009095419216140321,0.02227934875749793,,0.003875968992248069,-0.08563238982443566,0.03970009832841681,0.0087859424920127,12094,1167,0,516,2791,8136,6260
2020-04-23,la_rioja,La Rioja,John Hopkins University,3790,307,0,82,49,4,0,0,18,27,13,1519,1964,1344,0.0130981021117349,0.013201320132013139,,0.0,0.011992005329780175,0.013939081053174984,0.00976709241172058,3741,303,0,82,1501,1937,1331
2020-04-23,extremadura,Extremadura,John Hopkins University,2718,411,0,107,3,4,0,0,-122,121,38,949,1358,1413,0.0011049723756906271,0.00982800982800991,,0.0,-0.11391223155929042,0.09781729991915933,0.02763636363636368,2715,407,0,107,1071,1237,1375
2020-04-23,cantabria,Cantabria,John Hopkins University,2055,178,0,78,32,5,0,0,-36,63,13,964,913,978,0.015818091942659374,0.028901734104046284,,0.0,-0.03600000000000003,0.07411764705882362,0.013471502590673534,2023,173,0,78,1000,850,965
2020-04-24,castilla-la_mancha,Castilla-La Mancha,John Hopkins University,15509,2292,0,559,144,37,0,6,13,94,43,8341,4876,8385,0.009371949235275068,0.016407982261640752,,0.010849909584086825,0.0015609990393852247,0.01965704726056039,0.005154639175257714,15365,2255,0,553,8328,4782,8342
2020-04-24,navarra,Navarra,John Hopkins University,4627,429,0,129,46,12,0,0,-151,185,22,2461,1737,1937,0.010041475660336197,0.02877697841726623,,0.0,-0.057810107197549754,0.11920103092783507,0.011488250652741616,4581,417,0,129,2612,1552,1915
2020-04-24,melilla,Melilla,John Hopkins University,108,2,0,3,1,0,0,0,-15,16,0,29,77,44,0.009345794392523255,0.0,,0.0,-0.34090909090909094,0.2622950819672132,0.0,107,2,0,3,44,61,44
2020-04-24,canarias,Canarias,John Hopkins University,2155,130,0,171,15,2,0,2,-6,19,10,989,1036,878,0.007009345794392496,0.015625,,0.01183431952662728,-0.0060301507537688925,0.01868239921337267,0.011520737327188835,2140,128,0,169,995,1017,868
2020-04-24,baleares,Baleares,John Hopkins University,1845,174,0,165,26,2,0,0,3,21,18,569,1102,1057,0.014293567894447579,0.011627906976744207,,0.0,0.005300353356890497,0.01942645698427392,0.017324350336862304,1819,172,0,165,566,1081,1039
2020-04-24,murcia,Murcia,John Hopkins University,1468,126,0,105,0,1,0,0,-52,51,0,500,842,625,0.0,0.008000000000000007,,0.0,-0.09420289855072461,0.06447534766118834,0.0,1468,125,0,105,552,791,625
2020-04-24,cataluna,Cataluña,John Hopkins University,46261,4498,0,2576,717,105,0,7,-3,615,290,25010,16753,24420,0.015743017741085552,0.02390166173457775,,0.0027247956403269047,-0.00011993763243112188,0.03810881150080547,0.012018234562784835,45544,4393,0,2569,25013,16138,24130
2020-04-24,c_valenciana,C. Valenciana,John Hopkins University,10066,1172,0,653,127,25,0,2,-122,224,33,2861,6033,4978,0.012777945467350893,0.021795989537924942,,0.003072196620583778,-0.0408984244049615,0.03856085384747798,0.006673407482305382,9939,1147,0,651,2983,5809,4945
2020-04-24,asturias,Asturias,John Hopkins University,2249,235,0,117,4,7,0,0,-31,28,8,1298,716,1020,0.0017817371937638438,0.030701754385964897,,0.0,-0.02332580887885627,0.04069767441860472,0.007905138339920903,2245,228,0,117,1329,688,1012
2020-04-24,galicia,Galicia,John Hopkins University,9116,388,0,302,184,6,0,1,125,53,10,6945,1783,2717,0.020600089565606883,0.015706806282722585,,0.0033222591362125353,0.01832844574780057,0.03063583815028892,0.003694126339120807,8932,382,0,301,6820,1730,2707
2020-04-24,madrid,Madrid,John Hopkins University,61619,7848,0,892,520,83,0,-57,-253,690,-418,18869,34902,6183,0.008510777590468033,0.010688989053444953,,-0.060063224446786134,-0.013230833594812252,0.020168361978253335,-0.06332373882745035,61099,7765,0,949,19122,34212,6601
2020-04-24,andalucia,Andalucía,John Hopkins University,11645,1131,0,717,159,24,0,3,-168,303,40,6219,4295,5715,0.01384293923036739,0.021680216802167918,,0.004201680672268893,-0.026303428839830945,0.07590180360721432,0.007048458149779835,11486,1107,0,714,6387,3992,5675
2020-04-24,castilla_y_leon,Castilla y León,John Hopkins University,15990,1639,0,511,298,27,0,1,181,90,49,8318,6033,7555,0.018990568442518452,0.01674937965260548,,0.0019607843137254832,0.02224407029617792,0.015143866733972722,0.006528110844657542,15692,1612,0,510,8137,5943,7506
2020-04-24,ceuta,Ceuta,John Hopkins University,100,4,0,4,0,0,0,0,-14,14,0,-2,98,10,0.0,0.0,,0.0,-1.1666666666666667,0.16666666666666674,0.0,100,4,0,4,12,84,10
2020-04-24,aragon,Aragón,John Hopkins University,4922,709,0,255,55,14,0,1,-107,148,13,2284,1929,2372,0.011300595849599304,0.020143884892086295,,0.003937007874015741,-0.04475115014638231,0.08309938236945547,0.005510809665112415,4867,695,0,254,2391,1781,2359
2020-04-24,pais_vasco,País Vasco,John Hopkins University,12366,1212,0,525,162,19,0,7,-339,482,60,2213,8941,6375,0.01327433628318575,0.0159262363788768,,0.013513513513513598,-0.13283699059561127,0.05698073058281117,0.009501187648456089,12204,1193,0,518,2552,8459,6315
2020-04-24,la_rioja,La Rioja,John Hopkins University,3821,311,0,83,31,4,0,1,-8,35,16,1511,1999,1360,0.008179419525065956,0.013029315960912058,,0.012195121951219523,-0.005266622778143493,0.017820773930753653,0.011904761904761862,3790,307,0,82,1519,1964,1344
2020-04-24,extremadura,Extremadura,John Hopkins University,2718,416,0,107,0,5,0,0,-157,152,34,792,1510,1447,0.0,0.012165450121654597,,0.0,-0.16543730242360377,0.11192930780559651,0.02406227883934897,2718,411,0,107,949,1358,1413
2020-04-24,cantabria,Cantabria,John Hopkins University,2071,182,0,78,16,4,0,0,-121,133,4,843,1046,982,0.00778588807785896,0.022471910112359605,,0.0,-0.12551867219917012,0.14567360350492886,0.004089979550102152,2055,178,0,78,964,913,978
2020-04-25,castilla-la_mancha,Castilla-La Mancha,John Hopkins University,15609,2330,0,565,100,38,0,6,-258,320,32,8083,5196,8417,0.006447868979302385,0.016579406631762605,,0.01073345259391778,-0.03093154298045797,0.0656275635767023,0.003816338700059596,15509,2292,0,559,8341,4876,8385
2020-04-25,navarra,Navarra,John Hopkins University,4712,431,0,129,85,2,0,0,-15,98,5,2446,1835,1942,0.01837043440674302,0.004662004662004726,,0.0,-0.006095083299471726,0.05641911341393202,0.0025813113061434745,4627,429,0,129,2461,1737,1937
2020-04-25,melilla,Melilla,John Hopkins University,110,2,0,3,2,0,0,0,-2,4,0,27,81,44,0.0185185185185186,0.0,,0.0,-0.06896551724137934,0.051948051948051965,0.0,108,2,0,3,29,77,44
2020-04-25,canarias,Canarias,John Hopkins University,2167,131,0,171,12,1,0,0,-1,12,2,988,1048,880,0.005568445475637951,0.007692307692307665,,0.0,-0.0010111223458038054,0.01158301158301156,0.002277904328018332,2155,130,0,171,989,1036,878
2020-04-25,baleares,Baleares,John Hopkins University,1852,175,0,165,7,1,0,0,-15,21,4,554,1123,1061,0.003794037940379358,0.005747126436781658,,0.0,-0.026362038664323406,0.019056261343012748,0.0037842951750235443,1845,174,0,165,569,1102,1057
2020-04-25,murcia,Murcia,John Hopkins University,1474,127,0,106,6,1,0,1,-73,78,2,427,920,627,0.004087193460490468,0.007936507936507908,,0.00952380952380949,-0.14600000000000002,0.09263657957244664,0.0032000000000000917,1468,126,0,105,500,842,625
2020-04-25,cataluna,Cataluña,John Hopkins University,46811,4566,0,2583,550,68,0,7,229,253,1245,25239,17006,25665,0.011889064222563306,0.015117830146731848,,0.0027173913043478937,0.009156337465014097,0.015101772816809023,0.05098280098280106,46261,4498,0,2576,25010,16753,24420
2020-04-25,c_valenciana,C. Valenciana,John Hopkins University,10160,1186,0,654,94,14,0,1,-130,210,35,2731,6243,5013,0.009338366779256813,0.011945392491467643,,0.0015313935681469104,-0.045438657811953886,0.03480855295872698,0.007030936118923359,10066,1172,0,653,2861,6033,4978
2020-04-25,asturias,Asturias,John Hopkins University,2261,243,0,117,12,8,0,0,-29,33,2,1269,749,1022,0.00533570475767009,0.03404255319148941,,0.0,-0.02234206471494604,0.0460893854748603,0.0019607843137254832,2249,235,0,117,1298,716,1020
2020-04-25,galicia,Galicia,John Hopkins University,9176,394,0,303,60,6,0,1,34,20,7,6979,1803,2724,0.006581834137779685,0.015463917525773141,,0.0033112582781456013,0.004895608351331848,0.011217049915872135,0.0025763709974235827,9116,388,0,302,6945,1783,2717
2020-04-25,madrid,Madrid,John Hopkins University,61855,7922,0,873,236,74,0,-19,-303,465,-291,18566,35367,5892,0.0038299875038543263,0.00942915392456678,,-0.02130044843049328,-0.01605808468917269,0.013323018738181203,-0.047064531780689034,61619,7848,0,892,18869,34902,6183
2020-04-25,andalucia,Andalucía,John Hopkins University,11712,1145,0,716,67,14,0,-1,-393,446,32,5826,4741,5747,0.00575354229282965,0.012378426171529622,,-0.001394700139469962,-0.06319343945972022,0.10384167636786956,0.00559930008748899,11645,1131,0,717,6219,4295,5715
2020-04-25,castilla_y_leon,Castilla y León,John Hopkins University,16222,1666,0,515,232,27,0,4,30,175,98,8348,6208,7653,0.014509068167604777,0.016473459426479486,,0.007827788649706457,0.003606636210627512,0.029007127465605853,0.01297154202514883,15990,1639,0,511,8318,6033,7555
2020-04-25,ceuta,Ceuta,John Hopkins University,100,4,0,4,0,0,0,0,-6,6,0,-8,104,10,0.0,0.0,,0.0,,0.061224489795918435,0.0,100,4,0,4,-2,98,10
2020-04-25,aragon,Aragón,John Hopkins University,4955,712,0,257,33,3,0,2,-1,31,23,2283,1960,2395,0.006704591629418832,0.004231311706629048,,0.007843137254901933,-0.0004378283712784814,0.01607050285121825,0.009696458684654408,4922,709,0,255,2284,1929,2372
2020-04-25,pais_vasco,País Vasco,John Hopkins University,12455,1230,0,533,89,18,0,8,-590,661,51,1623,9602,6426,0.007197153485362984,0.014851485148514865,,0.015238095238095273,-0.2666064166290104,0.07392909070573772,0.008000000000000007,12366,1212,0,525,2213,8941,6375
2020-04-25,la_rioja,La Rioja,John Hopkins University,3861,315,0,84,40,4,0,1,-2,38,20,1509,2037,1380,0.01046846375294419,0.012861736334405238,,0.012048192771084265,-0.001323626737260053,0.019009504752376172,0.014705882352941124,3821,311,0,83,1511,1999,1360
2020-04-25,extremadura,Extremadura,John Hopkins University,2736,422,0,107,18,6,0,0,-60,72,33,732,1582,1480,0.0066225165562914245,0.014423076923076872,,0.0,-0.0757575757575758,0.04768211920529808,0.022805805114028965,2718,416,0,107,792,1510,1447
2020-04-25,cantabria,Cantabria,John Hopkins University,2083,183,0,78,12,1,0,0,-70,81,9,773,1127,991,0.005794302269435114,0.005494505494505475,,0.0,-0.08303677342823246,0.07743785850860418,0.009164969450101923,2071,182,0,78,843,1046,982
2020-04-26,castilla-la_mancha,Castilla-La Mancha,John Hopkins University,15664,2365,0,579,55,35,0,14,-66,86.0,27,8017,5282,8444,0.0035236081747709314,0.015021459227467782,,0.024778761061946986,-0.008165285166398584,0.016551193225558203,0.003207793750742649,15609,2330,0,565,8083,5196,8417
2020-04-26,navarra,Navarra,John Hopkins University,4733,432,0,130,21,1,0,1,-63,83.0,0,2383,1918,1942,0.0044567062818337,0.002320185614849146,,0.007751937984496138,-0.025756336876533115,0.045231607629427684,0.0,4712,431,0,129,2446,1835,1942
2020-04-26,melilla,Melilla,John Hopkins University,110,2,0,3,0,0,0,0,-6,6.0,0,21,87,44,0.0,0.0,,0.0,-0.2222222222222222,0.07407407407407418,0.0,110,2,0,3,27,81,44
2020-04-26,canarias,Canarias,John Hopkins University,2178,131,0,171,11,0,0,0,11,,1,999,1048,881,0.0050761421319796,0.0,,0.0,0.011133603238866474,,0.001136363636363713,2167,131,0,171,988,1048,880
2020-04-26,baleares,Baleares,John Hopkins University,1857,179,0,165,5,4,0,0,-12,13.0,0,542,1136,1061,0.0026997840172786614,0.02285714285714291,,0.0,-0.02166064981949456,0.011576135351736516,0.0,1852,175,0,165,554,1123,1061
2020-04-26,murcia,Murcia,John Hopkins University,1474,128,0,106,0,1,0,0,-71,70.0,0,356,990,627,0.0,0.007874015748031482,,0.0,-0.16627634660421542,0.07608695652173902,0.0,1474,127,0,106,427,920,627
2020-04-26,cataluna,Cataluña,John Hopkins University,47755,4699,0,2724,944,133,0,141,-80,891.0,134,25159,17897,25799,0.020166200252077493,0.029128339903635503,,0.05458768873403019,-0.0031696976900827956,0.05239327296248386,0.005221118254432167,46811,4566,0,2583,25239,17006,25665
2020-04-26,c_valenciana,C. Valenciana,John Hopkins University,10180,1189,0,656,20,3,0,2,-57,74.0,19,2674,6317,5032,0.0019685039370078705,0.002529510961214232,,0.003058103975535076,-0.02087147564994507,0.011853275668749053,0.0037901456213844664,10160,1186,0,654,2731,6243,5013
2020-04-26,asturias,Asturias,John Hopkins University,2263,248,0,117,2,5,0,0,-13,10.0,6,1256,759,1028,0.0008845643520565272,0.020576131687242816,,0.0,-0.010244286840031536,0.013351134846461887,0.005870841487279899,2261,243,0,117,1269,749,1022
2020-04-26,galicia,Galicia,John Hopkins University,9238,405,0,304,62,11,0,1,38,13.0,4,7017,1816,2728,0.006756756756756799,0.027918781725888353,,0.0033003300330032292,0.00544490614701254,0.007210205213532994,0.001468428781204123,9176,394,0,303,6979,1803,2724
2020-04-26,madrid,Madrid,John Hopkins University,61985,7986,0,3309,130,64,0,2436,-132,198.0,33580,18434,35565,39472,0.002101689434968801,0.008078767987881763,,2.790378006872852,-0.007109770548314076,0.005598439223004403,5.699253224711473,61855,7922,0,873,18566,35367,5892
2020-04-26,andalucia,Andalucía,John Hopkins University,11787,1157,0,720,75,12,0,4,-86,149.0,20,5740,4890,5767,0.006403688524590168,0.010480349344978102,,0.005586592178770999,-0.014761414349467872,0.03142796878295728,0.0034800765616842533,11712,1145,0,716,5826,4741,5747
2020-04-26,castilla_y_leon,Castilla y León,John Hopkins University,16404,1690,0,518,182,24,0,3,94,64.0,50,8442,6272,7703,0.011219331771668006,0.014405762304922076,,0.005825242718446644,0.011260182079539938,0.010309278350515427,0.006533385600418162,16222,1666,0,515,8348,6208,7653
2020-04-26,ceuta,Ceuta,John Hopkins University,100,4,0,4,0,0,0,0,-3,3.0,0,-11,107,10,0.0,0.0,,0.0,,0.028846153846153744,0.0,100,4,0,4,-8,104,10
2020-04-26,aragon,Aragón,John Hopkins University,4985,726,0,257,30,14,0,0,-34,50.0,8,2249,2010,2403,0.006054490413723412,0.0196629213483146,,0.0,-0.014892685063512934,0.025510204081632626,0.003340292275574086,4955,712,0,257,2283,1960,2395
2020-04-26,pais_vasco,País Vasco,John Hopkins University,12513,1241,0,538,58,11,0,5,-191,238.0,31,1432,9840,6457,0.004656764351665954,0.008943089430894391,,0.009380863039399667,-0.11768330252618608,0.02478650281191408,0.004824151882975469,12455,1230,0,533,1623,9602,6426
2020-04-26,la_rioja,La Rioja,John Hopkins University,3892,320,0,85,31,5,0,1,14,12.0,12,1523,2049,1392,0.008029008029007967,0.015873015873015817,,0.011904761904761862,0.009277667329357087,0.00589101620029453,0.008695652173912993,3861,315,0,84,1509,2037,1380
2020-04-26,extremadura,Extremadura,John Hopkins University,2749,428,0,107,13,6,0,0,-63,70.0,10,669,1652,1490,0.004751461988304007,0.014218009478673022,,0.0,-0.08606557377049184,0.04424778761061954,0.006756756756756799,2736,422,0,107,732,1582,1480
2020-04-26,cantabria,Cantabria,John Hopkins University,2104,186,0,78,21,3,0,0,-96,114.0,4,677,1241,995,0.01008161305808919,0.016393442622950838,,0.0,-0.1241914618369987,0.10115350488021302,0.004036326942482349,2083,183,0,78,773,1127,991
2020-04-27,castilla-la_mancha,Castilla-La Mancha,John Hopkins University,15706,2396,0,584,42,31,0,5,-13,24,20,8004,5306,8464,0.0026813074565883444,0.013107822410147962,,0.008635578583765069,-0.0016215541973306768,0.004543733434305253,0.002368545712932324,15664,2365,0,579,8017,5282,8444
2020-04-27,navarra,Navarra,John Hopkins University,4759,432,0,130,26,0,0,0,-34,60,3,2349,1978,1945,0.005493344601732453,0.0,,0.0,-0.014267729752412972,0.031282586027111536,0.001544799176107059,4733,432,0,130,2383,1918,1942
2020-04-27,melilla,Melilla,John Hopkins University,114,2,0,3,4,0,0,0,-1,5,0,20,92,44,0.036363636363636376,0.0,,0.0,-0.04761904761904767,0.05747126436781613,0.0,110,2,0,3,21,87,44
2020-04-27,canarias,Canarias,John Hopkins University,2187,133,0,174,9,2,0,3,-21,28,19,979,1075,900,0.004132231404958775,0.01526717557251911,,0.01754385964912286,-0.02100000000000002,0.026743075453677267,0.02156640181611813,2178,131,0,171,1000,1047,881
2020-04-27,baleares,Baleares,John Hopkins University,1868,181,0,165,11,2,0,0,-21,30,12,521,1166,1073,0.005923532579429125,0.011173184357541999,,0.0,-0.03874538745387457,0.02640845070422526,0.011310084825636224,1857,179,0,165,542,1136,1061
2020-04-27,murcia,Murcia,John Hopkins University,1475,130,0,106,1,2,0,0,-124,123,2,232,1113,629,0.0006784260515604323,0.015625,,0.0,-0.348314606741573,0.12424242424242427,0.0031897926634769647,1474,128,0,106,356,990,627
2020-04-27,cataluna,Cataluña,John Hopkins University,48158,4808,0,2750,403,109,0,26,-128,422,431,25031,18319,26230,0.00843890692074134,0.023196424771227964,,0.009544787077826689,-0.0050876425931077884,0.023579370844275527,0.016706073878832495,47755,4699,0,2724,25159,17897,25799
2020-04-27,c_valenciana,C. Valenciana,John Hopkins University,10204,1200,0,659,24,11,0,3,-93,106,14,2581,6423,5046,0.0023575638506876384,0.00925147182506314,,0.004573170731707377,-0.03477935676888555,0.016780117144214124,0.002782193958664525,10180,1189,0,656,2674,6317,5032
2020-04-27,asturias,Asturias,John Hopkins University,2269,252,0,117,6,4,0,0,-19,21,7,1237,780,1035,0.002651347768448886,0.016129032258064502,,0.0,-0.015127388535031816,0.027667984189723382,0.006809338521400754,2263,248,0,117,1256,759,1028
2020-04-27,galicia,Galicia,John Hopkins University,9328,412,0,305,90,7,0,1,58,25,6,7075,1841,2734,0.009742368478025565,0.01728395061728394,,0.00328947368421062,0.008265640587145517,0.013766519823788625,0.0021994134897360684,9238,405,0,304,7017,1816,2728
2020-04-27,madrid,Madrid,John Hopkins University,62579,8048,0,3338,594,62,0,29,256,276,162,18690,35841,39634,0.0095829636202307,0.007763586275983059,,0.008763977032336001,0.013887382011500415,0.007760438633487965,0.004104175111471431,61985,7986,0,3309,18434,35565,39472
2020-04-27,andalucia,Andalucía,John Hopkins University,11836,1168,0,721,49,11,0,1,-111,149,25,5629,5039,5792,0.00415712225332987,0.009507346585998278,,0.001388888888888884,-0.01933797909407664,0.03047034764826173,0.0043350095370209285,11787,1157,0,720,5740,4890,5767
2020-04-27,castilla_y_leon,Castilla y León,John Hopkins University,16589,1710,0,522,185,20,0,4,114,51,74,8556,6323,7777,0.011277737137283639,0.01183431952662728,,0.007722007722007707,0.013503909026297167,0.008131377551020336,0.009606646761002313,16404,1690,0,518,8442,6272,7703
2020-04-27,ceuta,Ceuta,John Hopkins University,100,4,0,4,0,0,0,0,-3,3,0,-14,110,10,0.0,0.0,,0.0,,0.028037383177569986,0.0,100,4,0,4,-11,107,10
2020-04-27,aragon,Aragón,John Hopkins University,5004,735,0,258,19,9,0,1,-61,71,22,2188,2081,2425,0.003811434302908756,0.012396694214876103,,0.0038910505836575737,-0.02712316585148955,0.035323383084577165,0.009155222638368654,4985,726,0,257,2249,2010,2403
2020-04-27,pais_vasco,País Vasco,John Hopkins University,12564,1255,0,539,51,14,0,1,-97,134,25,1335,9974,6482,0.004075761208343298,0.011281224818694646,,0.0018587360594795044,-0.06773743016759781,0.013617886178861838,0.0038717670744927712,12513,1241,0,538,1432,9840,6457
2020-04-27,la_rioja,La Rioja,John Hopkins University,3897,326,0,87,5,6,0,2,-16,15,8,1507,2064,1400,0.001284686536485058,0.018750000000000044,,0.0235294117647058,-0.01050558108995403,0.007320644216691097,0.005747126436781658,3892,320,0,85,1523,2049,1392
2020-04-27,extremadura,Extremadura,John Hopkins University,2751,433,0,107,2,5,0,0,-84,81,15,585,1733,1505,0.0007275372862858287,0.011682242990654235,,0.0,-0.12556053811659196,0.049031476997578594,0.010067114093959662,2749,428,0,107,669,1652,1490
2020-04-27,cantabria,Cantabria,John Hopkins University,2115,188,0,78,11,2,0,0,-40,49,5,637,1290,1000,0.005228136882129197,0.010752688172043001,,0.0,-0.05908419497784345,0.03948428686543104,0.005025125628140614,2104,186,0,78,677,1241,995
2020-04-28,castilla-la_mancha,Castilla-La Mancha,John Hopkins University,15785,2436,0,588,79,40,0,4,-37,76,59,7967,5382,8523,0.005029924869476732,0.016694490818029983,,0.006849315068493178,-0.004622688655672169,0.014323407463249227,0.006970699432892191,15706,2396,0,584,8004,5306,8464
2020-04-28,navarra,Navarra,John Hopkins University,4794,448,0,130,35,16,0,0,-85,104,6,2264,2082,1951,0.007354486236604396,0.03703703703703698,,0.0,-0.03618561089825456,0.05257836198179988,0.0030848329048842604,4759,432,0,130,2349,1978,1945
2020-04-28,melilla,Melilla,John Hopkins University,114,2,0,3,0,0,0,0,-3,3,0,17,95,44,0.0,0.0,,0.0,-0.15000000000000002,0.032608695652173836,0.0,114,2,0,3,20,92,44
2020-04-28,canarias,Canarias,John Hopkins University,2202,134,0,175,15,1,0,1,-18,32,6,961,1107,906,0.006858710562414272,0.007518796992481258,,0.005747126436781658,-0.018386108273748758,0.029767441860465205,0.006666666666666599,2187,133,0,174,979,1075,900
2020-04-28,baleares,Baleares,John Hopkins University,1877,185,0,165,9,4,0,0,-25,30,5,496,1196,1078,0.004817987152034187,0.022099447513812098,,0.0,-0.04798464491362764,0.02572898799313883,0.004659832246039164,1868,181,0,165,521,1166,1073
2020-04-28,murcia,Murcia,John Hopkins University,1480,130,0,106,5,0,0,0,-35,40,6,197,1153,635,0.003389830508474523,0.0,,0.0,-0.15086206896551724,0.035938903863432126,0.009538950715421324,1475,130,0,106,232,1113,629
2020-04-28,cataluna,Cataluña,John Hopkins University,48654,4905,0,2768,496,97,0,18,-342,741,316,24689,19060,26546,0.010299431039495044,0.0201747088186357,,0.006545454545454632,-0.013663057808317669,0.04044980621212946,0.012047274113610396,48158,4808,0,2750,25031,18319,26230
2020-04-28,c_valenciana,C. Valenciana,John Hopkins University,10236,1218,0,662,32,18,0,3,-162,176,26,2419,6599,5072,0.0031360250882006557,0.014999999999999902,,0.004552352048558417,-0.0627663696241767,0.02740152576677568,0.005152596115735264,10204,1200,0,659,2581,6423,5046
2020-04-28,asturias,Asturias,John Hopkins University,2284,259,0,117,15,7,0,0,-21,29,6,1216,809,1041,0.00661084178051996,0.02777777777777768,,0.0,-0.016976556184316927,0.03717948717948727,0.005797101449275255,2269,252,0,117,1237,780,1035
2020-04-28,galicia,Galicia,John Hopkins University,9328,551,0,308,0,139,0,3,-3691,3552,2,3384,5393,2736,0.0,0.337378640776699,,0.009836065573770592,-0.5216961130742049,1.9293862031504618,0.000731528895391298,9328,412,0,305,7075,1841,2734
2020-04-28,madrid,Madrid,John Hopkins University,63079,8105,0,3355,500,57,0,17,-30,473,216,18660,36314,39850,0.00798990076543249,0.007082504970178816,,0.005092869982025183,-0.0016051364365970988,0.013197176418068723,0.005449866276429294,62579,8048,0,3338,18690,35841,39634
2020-04-28,andalucia,Andalucía,John Hopkins University,11917,1188,0,722,81,20,0,1,-172,233,39,5457,5272,5831,0.0068435282189929225,0.017123287671232834,,0.001386962552011095,-0.030556049031799648,0.04623933320103202,0.006733425414364724,11836,1168,0,721,5629,5039,5792
2020-04-28,castilla_y_leon,Castilla y León,John Hopkins University,16690,1736,0,524,101,26,0,2,-50,125,77,8506,6448,7854,0.006088371812646987,0.015204678362572999,,0.003831417624521105,-0.005843852267414684,0.019769096947651388,0.00990099009900991,16589,1710,0,522,8556,6323,7777
2020-04-28,ceuta,Ceuta,John Hopkins University,101,4,0,4,1,0,0,0,-3,4,0,-17,114,10,0.010000000000000009,0.0,,0.0,,0.036363636363636376,0.0,100,4,0,4,-14,110,10
2020-04-28,aragon,Aragón,John Hopkins University,5042,736,0,258,38,1,0,0,-71,108,29,2117,2189,2454,0.007593924860112011,0.0013605442176871652,,0.0,-0.032449725776965255,0.05189812590100917,0.011958762886598029,5004,735,0,258,2188,2081,2425
2020-04-28,pais_vasco,País Vasco,John Hopkins University,12619,1274,0,540,55,19,0,1,-464,500,40,871,10474,6522,0.004377586755810237,0.015139442231075773,,0.0018552875695732052,-0.34756554307116105,0.05013033888109075,0.006170934896636782,12564,1255,0,539,1335,9974,6482
2020-04-28,la_rioja,La Rioja,John Hopkins University,3910,330,0,87,13,4,0,0,-18,27,13,1489,2091,1413,0.0033358994098025008,0.012269938650306678,,0.0,-0.011944260119442607,0.013081395348837122,0.009285714285714342,3897,326,0,87,1507,2064,1400
2020-04-28,extremadura,Extremadura,John Hopkins University,2764,440,0,107,13,7,0,0,-58,64,21,527,1797,1526,0.004725554343874894,0.01616628175519641,,0.0,-0.09914529914529913,0.036930178880554054,0.013953488372093092,2751,433,0,107,585,1733,1505
2020-04-28,cantabria,Cantabria,John Hopkins University,2146,191,0,79,31,3,0,1,-54,82,6,583,1372,1006,0.014657210401891163,0.015957446808510634,,0.012820512820512775,-0.0847723704866562,0.06356589147286829,0.006000000000000005,2115,188,0,78,637,1290,1000
2020-04-29,castilla-la_mancha,Castilla-La Mancha,John Hopkins University,15832,2463,0,592,47,27,0,4,-110,130,44,7857,5512,8567,0.0029775102945834853,0.011083743842364546,,0.006802721088435382,-0.013806953683946244,0.024154589371980784,0.005162501466619673,15785,2436,0,588,7967,5382,8523
2020-04-29,navarra,Navarra,John Hopkins University,4815,451,0,132,21,3,0,2,-13,31,14,2251,2113,1965,0.004380475594493172,0.006696428571428603,,0.01538461538461533,-0.005742049469964705,0.014889529298751203,0.007175807278318791,4794,448,0,130,2264,2082,1951
2020-04-29,melilla,Melilla,John Hopkins University,114,2,0,3,0,0,0,0,-1,1,0,16,96,44,0.0,0.0,,0.0,-0.05882352941176472,0.010526315789473717,0.0,114,2,0,3,17,95,44
2020-04-29,canarias,Canarias,John Hopkins University,2205,135,0,175,3,1,0,0,-22,24,3,939,1131,909,0.0013623978201635634,0.00746268656716409,,0.0,-0.02289281997918835,0.021680216802167918,0.0033112582781456013,2202,134,0,175,961,1107,906
2020-04-29,baleares,Baleares,John Hopkins University,1881,188,0,166,4,3,0,1,-22,23,3,474,1219,1081,0.0021310602024506853,0.016216216216216273,,0.0060606060606061,-0.04435483870967738,0.019230769230769162,0.002782931354359919,1877,185,0,165,496,1196,1078
2020-04-29,murcia,Murcia,John Hopkins University,1486,130,0,108,6,0,0,2,-43,49,2,154,1202,637,0.004054054054054124,0.0,,0.018867924528301883,-0.2182741116751269,0.04249783174327848,0.0031496062992126816,1480,130,0,106,197,1153,635
2020-04-29,cataluna,Cataluña,John Hopkins University,48916,4975,0,2784,262,70,0,16,-363,555,217,24326,19615,26763,0.005384963209602578,0.014271151885830724,,0.005780346820809301,-0.014702904127344207,0.02911857292759712,0.008174489565282883,48654,4905,0,2768,24689,19060,26546
2020-04-29,c_valenciana,C. Valenciana,John Hopkins University,10331,1236,0,663,95,18,0,1,-210,287,24,2209,6886,5096,0.009280969128565797,0.014778325123152802,,0.0015105740181269312,-0.08681273253410504,0.04349143809668132,0.004731861198738141,10236,1218,0,662,2419,6599,5072
2020-04-29,asturias,Asturias,John Hopkins University,2295,263,0,117,11,4,0,0,-19,26,6,1197,835,1047,0.004816112084063073,0.015444015444015413,,0.0,-0.015625,0.03213844252163156,0.0057636887608070175,2284,259,0,117,1216,809,1041
2020-04-29,galicia,Galicia,John Hopkins University,8731,551,0,310,38,0,0,2,-142,180,11,2607,5573,2747,0.004371333256643295,0.0,,0.006493506493506551,-0.0516551473263005,0.03337659929538295,0.004020467836257202,8693,551,0,308,2749,5393,2736
2020-04-29,madrid,Madrid,John Hopkins University,63454,8176,0,3377,375,71,0,22,-89,393,226,18571,36707,40076,0.005944926203649281,0.00876002467612591,,0.006557377049180246,-0.004769560557341901,0.010822272401828537,0.005671267252195689,63079,8105,0,3355,18660,36314,39850
2020-04-29,andalucia,Andalucía,John Hopkins University,11949,1207,0,721,32,19,0,-1,-425,438,42,5032,5710,5873,0.0026852395737182455,0.015993265993266004,,-0.0013850415512465242,-0.07788161993769471,0.08308042488619116,0.007202881152460927,11917,1188,0,722,5457,5272,5831
2020-04-29,castilla_y_leon,Castilla y León,John Hopkins University,16885,1752,0,528,195,16,0,4,58,121,103,8564,6569,7957,0.011683642899940061,0.009216589861751112,,0.007633587786259444,0.006818716200329256,0.018765508684863486,0.013114336643748503,16690,1736,0,524,8506,6448,7854
2020-04-29,ceuta,Ceuta,John Hopkins University,101,4,0,4,0,0,0,0,-12,12,0,-29,126,10,0.0,0.0,,0.0,,0.10526315789473695,0.0,101,4,0,4,-17,114,10
2020-04-29,aragon,Aragón,John Hopkins University,5091,739,0,258,49,3,0,0,-56,102,23,2061,2291,2477,0.00971836572788587,0.0040760869565217295,,0.0,-0.026452527161077044,0.04659661946094107,0.009372453137734382,5042,736,0,258,2117,2189,2454
2020-04-29,pais_vasco,País Vasco,John Hopkins University,12701,1296,0,541,82,22,0,1,-402,462,39,469,10936,6561,0.006498137728821574,0.017268445839874413,,0.0018518518518517713,-0.46153846153846156,0.044109222837502404,0.005979760809567525,12619,1274,0,540,871,10474,6522
2020-04-29,la_rioja,La Rioja,John Hopkins University,3918,332,0,88,8,2,0,1,-62,68,11,1427,2159,1424,0.002046035805626678,0.0060606060606061,,0.011494252873563315,-0.04163868368032242,0.03252032520325199,0.007784854918612805,3910,330,0,87,1489,2091,1413
2020-04-29,extremadura,Extremadura,John Hopkins University,2785,446,0,108,21,6,0,1,-75,90,24,452,1887,1550,0.007597684515195269,0.013636363636363669,,0.009345794392523255,-0.14231499051233398,0.05008347245409017,0.01572739187418093,2764,440,0,107,527,1797,1526
2020-04-29,cantabria,Cantabria,John Hopkins University,2173,191,0,79,27,0,0,0,-84,111,1,499,1483,1007,0.012581547064305587,0.0,,0.0,-0.144082332761578,0.08090379008746362,0.0009940357852882276,2146,191,0,79,583,1372,1006
2020-04-30,castilla-la_mancha,Castilla-La Mancha,John Hopkins University,15910,2498,0,596,78,35,0,4,-60,103.0,51,7797,5615,8618,0.004926730672056623,0.014210312626877775,,0.006756756756756799,-0.0076365024818633165,0.01868650217706813,0.005953075755807058,15832,2463,0,592,7857,5512,8567
2020-04-30,navarra,Navarra,John Hopkins University,4848,458,0,132,33,7,0,0,-46,72.0,12,2205,2185,1977,0.006853582554517068,0.015521064301552201,,0.0,-0.02043536206130614,0.03407477520113589,0.006106870229007688,4815,451,0,132,2251,2113,1965
2020-04-30,melilla,Melilla,John Hopkins University,115,2,0,3,1,0,0,0,1,,0,17,96,44,0.00877192982456143,0.0,,0.0,0.0625,,0.0,114,2,0,3,16,96,44
2020-04-30,canarias,Canarias,John Hopkins University,2206,136,0,175,1,1,0,0,-20,20.0,5,919,1151,914,0.00045351473922905505,0.007407407407407307,,0.0,-0.021299254526091604,0.017683465959328126,0.005500550055005604,2205,135,0,175,939,1131,909
2020-04-30,baleares,Baleares,John Hopkins University,1892,193,0,166,11,5,0,0,-20,26.0,8,454,1245,1089,0.005847953216374213,0.02659574468085113,,0.0,-0.04219409282700426,0.021328958162428302,0.007400555041628065,1881,188,0,166,474,1219,1081
2020-04-30,murcia,Murcia,John Hopkins University,1488,132,0,109,2,2,0,1,-27,27.0,1,127,1229,638,0.0013458950201883368,0.01538461538461533,,0.0092592592592593,-0.17532467532467533,0.022462562396006636,0.0015698587127157548,1486,130,0,108,154,1202,637
2020-04-30,cataluna,Cataluña,John Hopkins University,49307,5061,0,2795,391,86,0,11,280,25.0,169,24606,19640,26932,0.007993294627524739,0.017286432160803944,,0.0039511494252872925,0.011510318178081125,0.0012745347947999974,0.006314688188917561,48916,4975,0,2784,24326,19615,26763
2020-04-30,c_valenciana,C. Valenciana,John Hopkins University,10347,1245,0,694,16,9,0,31,-185,192.0,30,2024,7078,5126,0.0015487368115381095,0.00728155339805836,,0.046757164404223284,-0.08374830239927566,0.027882660470519793,0.005886970172684469,10331,1236,0,663,2209,6886,5096
2020-04-30,asturias,Asturias,John Hopkins University,2310,264,0,118,15,1,0,1,-11,25.0,1,1186,860,1048,0.006535947712418277,0.0038022813688212143,,0.008547008547008517,-0.009189640768588192,0.029940119760478945,0.0009551098376312517,2295,263,0,117,1197,835,1047
2020-04-30,galicia,Galicia,John Hopkins University,8769,558,0,313,38,7,0,3,-212,243.0,12,2395,5816,2759,0.004352307868514593,0.012704174228675091,,0.00967741935483879,-0.081319524357499,0.04360308630898979,0.004368401892974161,8731,551,0,310,2607,5573,2747
2020-04-30,madrid,Madrid,John Hopkins University,63747,8222,0,3392,293,46,0,15,-200,447.0,217,18371,37154,40293,0.004617518202162163,0.005626223091976579,,0.004441812259401878,-0.010769479295676065,0.012177513825700759,0.005414712047110415,63454,8176,0,3377,18571,36707,40076
2020-04-30,andalucia,Andalucía,John Hopkins University,12061,1238,0,729,112,31,0,8,-543,624.0,62,4489,6334,5935,0.009373169302870465,0.025683512841756517,,0.01109570041608876,-0.10790937996820349,0.10928196147110336,0.010556785288608816,11949,1207,0,721,5032,5710,5873
2020-04-30,castilla_y_leon,Castilla y León,John Hopkins University,16993,1770,0,531,108,18,0,3,-27,117.0,53,8537,6686,8010,0.006396209653538598,0.010273972602739656,,0.005681818181818121,-0.003152732368052358,0.017810930126350932,0.00666080180972739,16885,1752,0,528,8564,6569,7957
2020-04-30,ceuta,Ceuta,John Hopkins University,101,4,0,4,0,0,0,0,-12,12.0,0,-41,138,10,0.0,0.0,,0.0,,0.09523809523809534,0.0,101,4,0,4,-29,126,10
2020-04-30,aragon,Aragón,John Hopkins University,5116,749,0,260,25,10,0,2,-76,91.0,17,1985,2382,2494,0.004910626595953538,0.013531799729364025,,0.007751937984496138,-0.03687530325084909,0.039720646006110805,0.006863140896245401,5091,739,0,258,2061,2291,2477
2020-04-30,pais_vasco,País Vasco,John Hopkins University,12824,1312,0,544,123,16,0,3,-337,444.0,46,132,11380,6607,0.009684276828596072,0.012345679012345734,,0.005545286506469571,-0.7185501066098081,0.04059985369422092,0.007011126352690189,12701,1296,0,541,469,10936,6561
2020-04-30,la_rioja,La Rioja,John Hopkins University,3936,333,0,88,18,1,0,0,-44,61.0,9,1383,2220,1433,0.004594180704440953,0.003012048192771122,,0.0,-0.03083391730903995,0.02825382121352482,0.006320224719101208,3918,332,0,88,1427,2159,1424
2020-04-30,extremadura,Extremadura,John Hopkins University,2811,451,0,108,26,5,0,0,-52,73.0,15,400,1960,1565,0.009335727109515357,0.011210762331838486,,0.0,-0.11504424778761058,0.03868574456809748,0.00967741935483879,2785,446,0,108,452,1887,1550
2020-04-30,cantabria,Cantabria,John Hopkins University,2184,192,0,79,11,1,0,0,-16,26.0,2,483,1509,1009,0.005062126092959085,0.005235602094240788,,0.0,-0.03206412825651306,0.017532029669588667,0.0019860973187686426,2173,191,0,79,499,1483,1007
2020-05-01,castilla-la_mancha,Castilla-La Mancha,John Hopkins University,15967,2534,0,601,57,36,0,5,-66.0,87.0,27,7731,5702,8645,0.003582652419861665,0.014411529223378627,,0.008389261744966348,-0.008464794151596733,0.015494211932324031,0.0031329774889765627,15910,2498,0,596,7797,5615,8618
2020-05-01,navarra,Navarra,John Hopkins University,4888,460,0,132,40,2,0,0,-58.0,96.0,2,2147,2281,1979,0.008250825082508184,0.004366812227074135,,0.0,-0.026303854875283417,0.04393592677345537,0.001011633788568611,4848,458,0,132,2205,2185,1977
2020-05-01,melilla,Melilla,John Hopkins University,115,2,0,3,0,0,0,0,,,0,17,96,44,0.0,0.0,,0.0,,,0.0,115,2,0,3,17,96,44
2020-05-01,canarias,Canarias,John Hopkins University,2212,140,0,175,6,4,0,0,2.0,,4,921,1151,918,0.0027198549410698547,0.02941176470588225,,0.0,0.0021762785636560977,,0.004376367614879584,2206,136,0,175,919,1151,914
2020-05-01,baleares,Baleares,John Hopkins University,1900,197,0,166,8,4,0,0,-19.0,23.0,4,435,1268,1093,0.0042283298097252064,0.020725388601036343,,0.0,-0.04185022026431717,0.01847389558232937,0.0036730945821854544,1892,193,0,166,454,1245,1089
2020-05-01,murcia,Murcia,John Hopkins University,1491,132,0,110,3,0,0,1,-19.0,22.0,1,108,1251,639,0.002016129032258007,0.0,,0.00917431192660545,-0.14960629921259838,0.017900732302685185,0.0015673981191222097,1488,132,0,109,127,1229,638
2020-05-01,cataluna,Cataluña,John Hopkins University,49850,5137,0,2811,543,76,0,16,194.0,273.0,117,24800,19913,27049,0.011012635122801928,0.015016795099782598,,0.005724508050089394,0.007884255872551371,0.013900203665987876,0.0043442744690331825,49307,5061,0,2795,24606,19640,26932
2020-05-01,c_valenciana,C. Valenciana,John Hopkins University,10411,1258,0,695,64,13,0,1,-158.0,209.0,27,1866,7287,5153,0.00618536773944145,0.010441767068273045,,0.0014409221902016434,-0.07806324110671936,0.029528115286804102,0.005267264923917381,10347,1245,0,694,2024,7078,5126
2020-05-01,asturias,Asturias,John Hopkins University,2311,270,0,120,1,6,0,2,-35.0,30.0,4,1151,890,1052,0.00043290043290045155,0.022727272727272707,,0.016949152542372836,-0.0295109612141653,0.03488372093023262,0.003816793893129722,2310,264,0,118,1186,860,1048
2020-05-01,galicia,Galicia,John Hopkins University,8804,563,0,313,35,5,0,0,-135.0,165.0,10,2260,5981,2769,0.003991333105257233,0.008960573476702427,,0.0,-0.056367432150313146,0.02837001375515813,0.0036245016310256783,8769,558,0,313,2395,5816,2759
2020-05-01,madrid,Madrid,John Hopkins University,63892,8292,0,3404,145,70,0,12,-301.0,376.0,164,18070,37530,40457,0.0022746168447143056,0.00851374361469226,,0.0035377358490567,-0.016384519078983195,0.010120040910803763,0.004070185888367606,63747,8222,0,3392,18371,37154,40293
2020-05-01,andalucia,Andalucía,John Hopkins University,12105,1253,0,735,44,15,0,6,-458.0,487.0,26,4031,6821,5961,0.0036481220462647457,0.012116316639741553,,0.008230452674897082,-0.10202717754511026,0.07688664351120944,0.004380791912384163,12061,1238,0,729,4489,6334,5935
2020-05-01,castilla_y_leon,Castilla y León,John Hopkins University,17165,1788,0,531,172,18,0,0,27.0,127.0,44,8564,6813,8054,0.010121814864944456,0.01016949152542379,,0.0,0.003162703525828814,0.018994914747233027,0.005493133583021281,16993,1770,0,531,8537,6686,8010
2020-05-01,ceuta,Ceuta,John Hopkins University,101,4,0,4,0,0,0,0,-2.0,2.0,0,-43,140,10,0.0,0.0,,0.0,,0.01449275362318847,0.0,101,4,0,4,-41,138,10
2020-05-01,aragon,Aragón,John Hopkins University,5136,761,0,260,20,12,0,0,-84.0,92.0,9,1901,2474,2503,0.00390930414386248,0.01602136181575431,,0.0,-0.04231738035264487,0.03862300587741396,0.003608660785886064,5116,749,0,260,1985,2382,2494
2020-05-01,pais_vasco,País Vasco,John Hopkins University,12887,1321,0,551,63,9,0,7,-371.0,425.0,52,-239,11805,6659,0.004912663755458624,0.006859756097560954,,0.012867647058823595,-2.8106060606060606,0.03734622144112487,0.007870440441955395,12824,1312,0,544,132,11380,6607
2020-05-01,la_rioja,La Rioja,John Hopkins University,3947,334,0,88,11,1,0,0,-49.0,59.0,6,1334,2279,1439,0.0027947154471543723,0.0030030030030030463,,0.0,-0.03543022415039765,0.026576576576576638,0.004187020237264472,3936,333,0,88,1383,2220,1433
2020-05-01,extremadura,Extremadura,John Hopkins University,2824,458,0,108,13,7,0,0,-51.0,57.0,27,349,2017,1592,0.00462468872287447,0.015521064301552201,,0.0,-0.12749999999999995,0.029081632653061185,0.017252396166134165,2811,451,0,108,400,1960,1565
2020-05-01,cantabria,Cantabria,John Hopkins University,2201,193,0,79,17,1,0,0,-26.0,42.0,0,457,1551,1009,0.007783882783882756,0.005208333333333259,,0.0,-0.053830227743271175,0.027833001988071482,0.0,2184,192,0,79,483,1509,1009
2020-05-02,castilla-la_mancha,Castilla-La Mancha,John Hopkins University,16017,2565,0,604,50,31,0,3,-51.0,70,31,7680,5772,8676,0.00313145863343145,0.012233622730860372,,0.004991680532445919,-0.006596818005432659,0.012276394247632494,0.003585887796414111,15967,2534,0,601,7731,5702,8645
2020-05-02,navarra,Navarra,John Hopkins University,4902,462,0,133,14,2,0,1,-118.0,130,7,2029,2411,1986,0.002864157119476296,0.004347826086956497,,0.007575757575757569,-0.05496040987424311,0.056992547128452475,0.0035371399696817463,4888,460,0,132,2147,2281,1979
2020-05-02,melilla,Melilla,John Hopkins University,117,2,0,3,2,0,0,0,,2,0,17,98,44,0.017391304347825987,0.0,,0.0,,0.02083333333333326,0.0,115,2,0,3,17,96,44
2020-05-02,canarias,Canarias,John Hopkins University,2221,140,0,175,9,0,0,0,8.0,1,1,931,1150,919,0.004068716094032476,0.0,,0.0,0.008667388949079147,0.0008703220191470518,0.0010893246187364536,2212,140,0,175,923,1149,918
2020-05-02,baleares,Baleares,John Hopkins University,1906,197,0,166,6,0,0,0,-10.0,16,5,425,1284,1098,0.0031578947368420263,0.0,,0.0,-0.02298850574712641,0.012618296529968376,0.0045745654162854255,1900,197,0,166,435,1268,1093
2020-05-02,murcia,Murcia,John Hopkins University,1492,134,0,110,1,2,0,0,-10.0,9,2,98,1260,641,0.0006706908115359234,0.015151515151515138,,0.0,-0.09259259259259256,0.007194244604316502,0.003129890453834161,1491,132,0,110,108,1251,639
2020-05-02,cataluna,Cataluña,John Hopkins University,50234,5185,0,2844,384,48,0,33,-83.0,419,208,24717,20332,27257,0.007703109327984015,0.009343975082733103,,0.011739594450373536,-0.003346774193548341,0.021041530658363783,0.0076897482346851564,49850,5137,0,2811,24800,19913,27049
2020-05-02,c_valenciana,C. Valenciana,John Hopkins University,10436,1264,0,698,25,6,0,3,-141.0,160,28,1725,7447,5181,0.0024013063106329557,0.004769475357710551,,0.004316546762589857,-0.07556270096463025,0.021956909564978755,0.005433727925480358,10411,1258,0,695,1866,7287,5153
2020-05-02,asturias,Asturias,John Hopkins University,2313,270,0,120,2,0,0,0,-16.0,18,3,1135,908,1055,0.0008654262224145892,0.0,,0.0,-0.013900955690703709,0.020224719101123556,0.002851711026615966,2311,270,0,120,1151,890,1052
2020-05-02,galicia,Galicia,John Hopkins University,8837,569,0,315,33,6,0,2,-67.0,94,5,2193,6075,2774,0.0037482962289867583,0.010657193605683846,,0.006389776357827559,-0.029646017699115013,0.015716435378699156,0.0018057060310581186,8804,563,0,313,2260,5981,2769
2020-05-02,madrid,Madrid,John Hopkins University,64009,8332,0,3421,117,40,0,17,-97.0,174,140,17973,37704,40597,0.0018312151756088024,0.004823926676314594,,0.004994124559341895,-0.005368013281682349,0.004636290967226175,0.003460464196554325,63892,8292,0,3404,18070,37530,40457
2020-05-02,andalucia,Andalucía,John Hopkins University,12139,1256,0,736,34,3,0,1,-45.0,76,0,3986,6897,5961,0.002808756712102456,0.002394253790901857,,0.0013605442176871652,-0.011163483006698116,0.011142061281337101,0.0,12105,1253,0,735,4031,6821,5961
2020-05-02,castilla_y_leon,Castilla y León,John Hopkins University,17283,1800,0,533,118,12,0,2,63.0,43,31,8627,6856,8085,0.0068744538304690295,0.006711409395973256,,0.0037664783427495685,0.0073563755254553165,0.006311463378834592,0.0038490191209337166,17165,1788,0,531,8564,6813,8054
2020-05-02,ceuta,Ceuta,John Hopkins University,101,4,0,4,0,0,0,0,-1.0,1,0,-44,141,10,0.0,0.0,,0.0,,0.0071428571428571175,0.0,101,4,0,4,-43,140,10
2020-05-02,aragon,Aragón,John Hopkins University,5164,761,0,260,28,0,0,0,-56.0,84,16,1845,2558,2519,0.005451713395638658,0.0,,0.0,-0.029458179905312964,0.03395311236863385,0.006392329204954139,5136,761,0,260,1901,2474,2503
2020-05-02,pais_vasco,País Vasco,John Hopkins University,12938,1329,0,553,51,8,0,2,-176.0,219,33,-415,12024,6692,0.003957476526732284,0.006056018168054456,,0.003629764065335772,,0.0185514612452351,0.004955699053911911,12887,1321,0,551,-239,11805,6659
2020-05-02,la_rioja,La Rioja,John Hopkins University,3952,335,0,88,5,1,0,0,-14.0,18,7,1320,2297,1446,0.001266784899923934,0.0029940119760478723,,0.0,-0.010494752623688153,0.007898200965335667,0.004864489228630919,3947,334,0,88,1334,2279,1439
2020-05-02,extremadura,Extremadura,John Hopkins University,2844,460,0,108,20,2,0,0,-37.0,55,11,312,2072,1603,0.007082152974504208,0.004366812227074135,,0.0,-0.10601719197707737,0.027268220128904286,0.006909547738693567,2824,458,0,108,349,2017,1592
2020-05-02,cantabria,Cantabria,John Hopkins University,2205,195,0,79,4,2,0,0,-63.0,65,1,394,1616,1010,0.0018173557473875057,0.010362694300518172,,0.0,-0.137855579868709,0.04190844616376532,0.0009910802775023875,2201,193,0,79,457,1551,1009
2020-05-03,castilla-la_mancha,Castilla-La Mancha,John Hopkins University,16050,2590,0,606,33,25,0,2,-14,22.0,22,7666,5794,8698,0.0020603109196479785,0.00974658869395717,,0.0033112582781456013,-0.001822916666666674,0.003811503811503858,0.0025357307514983773,16017,2565,0,604,7680,5772,8676
2020-05-03,navarra,Navarra,John Hopkins University,4918,466,0,133,16,4,0,0,-71,83.0,4,1958,2494,1990,0.003263973888208982,0.008658008658008587,,0.0,-0.034992607195662884,0.03442554956449606,0.002014098690835908,4902,462,0,133,2029,2411,1986
2020-05-03,melilla,Melilla,John Hopkins University,119,2,0,3,2,0,0,0,-1,3.0,0,16,101,44,0.017094017094017033,0.0,,0.0,-0.05882352941176472,0.030612244897959107,0.0,117,2,0,3,17,98,44
2020-05-03,canarias,Canarias,John Hopkins University,2225,141,0,175,4,1,0,0,-13,16.0,0,918,1166,919,0.0018009905447995411,0.0071428571428571175,,0.0,-0.013963480128893702,0.013913043478260834,0.0,2221,140,0,175,931,1150,919
2020-05-03,baleares,Baleares,John Hopkins University,1906,197,0,166,0,0,0,0,-10,10.0,3,415,1294,1101,0.0,0.0,,0.0,-0.02352941176470591,0.007788161993769416,0.002732240437158362,1906,197,0,166,425,1284,1098
2020-05-03,murcia,Murcia,John Hopkins University,1492,134,0,110,0,0,0,0,-17,17.0,4,81,1277,645,0.0,0.0,,0.0,-0.173469387755102,0.013492063492063444,0.006240249609984483,1492,134,0,110,98,1260,641
2020-05-03,cataluna,Cataluña,John Hopkins University,50366,5220,0,2847,132,35,0,3,-1469,1566.0,64,23248,21898,27321,0.002627702352987926,0.0067502410800386325,,0.001054852320675037,-0.05943277905894728,0.07702144402911659,0.0023480206919324065,50234,5185,0,2844,24717,20332,27257
2020-05-03,c_valenciana,C. Valenciana,John Hopkins University,10436,1269,0,700,0,5,0,2,-64,59.0,23,1661,7506,5204,0.0,0.003955696202531556,,0.002865329512893977,-0.0371014492753623,0.00792265341748366,0.0044392974329279244,10436,1264,0,698,1725,7447,5181
2020-05-03,asturias,Asturias,John Hopkins University,2315,274,0,120,2,4,0,0,-11,9.0,2,1124,917,1057,0.0008646779074794608,0.014814814814814836,,0.0,-0.00969162995594719,0.009911894273127775,0.0018957345971564177,2313,270,0,120,1135,908,1055
2020-05-03,galicia,Galicia,John Hopkins University,8859,575,0,315,22,6,0,0,-143,159.0,8,2050,6234,2782,0.0024895326468259427,0.010544815465729274,,0.0,-0.06520747834017326,0.026172839506172885,0.002883922134102379,8837,569,0,315,2193,6075,2774
2020-05-03,madrid,Madrid,John Hopkins University,64121,8376,0,3431,112,44,0,10,-36,104.0,144,17937,37808,40741,0.0017497539408519724,0.005280844935189544,,0.0029231218941829784,-0.0020030045067601643,0.0027583280288563383,0.003547060127595536,64009,8332,0,3421,17973,37704,40597
2020-05-03,andalucia,Andalucía,John Hopkins University,12156,1263,0,738,17,7,0,2,-114,124.0,12,3872,7021,5973,0.0014004448471867104,0.005573248407643394,,0.0027173913043478937,-0.028600100351229285,0.01797883137596057,0.0020130850528434774,12139,1256,0,736,3986,6897,5961
2020-05-03,castilla_y_leon,Castilla y León,John Hopkins University,17334,1818,0,534,51,18,0,1,-11,44.0,38,8616,6900,8123,0.002950876583926343,0.010000000000000009,,0.0018761726078799779,-0.001275066651211354,0.0064177362893815815,0.0047000618429189345,17283,1800,0,533,8627,6856,8085
2020-05-03,ceuta,Ceuta,John Hopkins University,101,4,0,4,0,0,0,0,-1,1.0,0,-45,142,10,0.0,0.0,,0.0,,0.007092198581560183,0.0,101,4,0,4,-44,141,10
2020-05-03,aragon,Aragón,John Hopkins University,5188,762,0,260,24,1,0,0,-43,66.0,7,1802,2624,2526,0.004647560030983655,0.0013140604467805073,,0.0,-0.023306233062330595,0.02580140734949188,0.0027788805081381263,5164,761,0,260,1845,2558,2519
2020-05-03,pais_vasco,País Vasco,John Hopkins University,12952,1341,0,554,14,12,0,1,-129,131.0,27,-544,12155,6719,0.001082083784201604,0.009029345372460584,,0.001808318264014508,,0.010894876912840967,0.0040346682606096085,12938,1329,0,553,-415,12024,6692
2020-05-03,la_rioja,La Rioja,John Hopkins University,3961,335,0,88,9,0,0,0,-6,15.0,3,1314,2312,1449,0.0022773279352226172,0.0,,0.0,-0.004545454545454519,0.006530256856769778,0.0020746887966804906,3952,335,0,88,1320,2297,1446
2020-05-03,extremadura,Extremadura,John Hopkins University,2849,460,0,108,5,0,0,0,-13,18.0,15,299,2090,1618,0.0017580872011251358,0.0,,0.0,-0.04166666666666663,0.008687258687258614,0.009357454772301876,2844,460,0,108,312,2072,1603
2020-05-03,cantabria,Cantabria,John Hopkins University,2206,197,0,79,1,2,0,0,-1,,1,393,1616,1011,0.00045351473922905505,0.01025641025641022,,0.0,-0.0025380710659898,,0.000990099009900991,2205,195,0,79,394,1616,1010
2020-05-04,castilla-la_mancha,Castilla-La Mancha,John Hopkins University,16080,2616,0,609,30,26,0,3,-26.0,30.0,27,7640,5824,8725,0.0018691588785046953,0.010038610038610063,,0.004950495049504955,-0.0033915992695017216,0.005177770107007262,0.0031041618762934764,16050,2590,0,606,7666,5794,8698
2020-05-04,navarra,Navarra,John Hopkins University,4936,471,0,134,18,5,0,1,-55.0,68.0,5,1903,2562,1995,0.0036600244001627757,0.010729613733905685,,0.007518796992481258,-0.028089887640449396,0.027265437048917374,0.002512562814070307,4918,466,0,133,1958,2494,1990
2020-05-04,melilla,Melilla,John Hopkins University,119,2,0,3,0,0,0,0,,,0,16,101,44,0.0,0.0,,0.0,,,0.0,119,2,0,3,16,101,44
2020-05-04,canarias,Canarias,John Hopkins University,2231,142,0,176,6,1,0,1,-19.0,24.0,1,899,1190,920,0.002696629213483126,0.007092198581560183,,0.005714285714285783,-0.020697167755991286,0.020583190394511064,0.0010881392818280489,2225,141,0,175,918,1166,919
2020-05-04,baleares,Baleares,John Hopkins University,1908,198,0,167,2,1,0,1,-12.0,13.0,8,403,1307,1109,0.0010493179433368471,0.0050761421319796,,0.006024096385542244,-0.028915662650602414,0.01004636785162294,0.0072661217075387086,1906,197,0,166,415,1294,1101
2020-05-04,murcia,Murcia,John Hopkins University,1496,136,0,111,4,2,0,1,-102.0,104.0,5,-21,1381,650,0.002680965147453085,0.014925373134328401,,0.009090909090909038,-1.2592592592592593,0.08144087705559899,0.007751937984496138,1492,134,0,110,81,1277,645
2020-05-04,cataluna,Cataluña,John Hopkins University,50771,5270,0,2856,405,50,0,9,-300.0,655.0,424,22948,22553,27745,0.008041138863519093,0.009578544061302763,,0.0031612223393044925,-0.012904335856847915,0.02991140743446885,0.015519197686761022,50366,5220,0,2847,23248,21898,27321
2020-05-04,c_valenciana,C. Valenciana,John Hopkins University,10500,1279,0,701,64,10,0,1,-95.0,149.0,10,1566,7655,5214,0.006132617861249523,0.007880220646178104,,0.0014285714285713347,-0.05719446116797111,0.0198507860378363,0.0019215987701768356,10436,1269,0,700,1661,7506,5204
2020-05-04,asturias,Asturias,John Hopkins University,2316,275,0,120,1,1,0,0,-19.0,19.0,4,1105,936,1061,0.00043196544276447035,0.0036496350364962904,,0.0,-0.01690391459074736,0.02071973827699014,0.0037842951750235443,2315,274,0,120,1124,917,1057
2020-05-04,galicia,Galicia,John Hopkins University,8881,579,0,317,22,4,0,2,-309.0,327.0,10,1741,6561,2792,0.002483350265267026,0.006956521739130528,,0.006349206349206327,-0.1507317073170732,0.05245428296438881,0.0035945363048166534,8859,575,0,315,2050,6234,2782
2020-05-04,madrid,Madrid,John Hopkins University,64452,8420,0,3442,331,44,0,11,93.0,194.0,110,18030,38002,40851,0.005162115375618059,0.005253104106972328,,0.003206062372486107,0.005184813513965603,0.005131189166313943,0.0026999828182912022,64121,8376,0,3431,17937,37808,40741
2020-05-04,andalucia,Andalucía,John Hopkins University,12167,1267,0,738,11,4,0,0,-202.0,209.0,10,3670,7230,5983,0.0009049029285950194,0.003167062549485289,,0.0,-0.052169421487603285,0.029767839339125413,0.0016742005692282902,12156,1263,0,738,3872,7021,5973
2020-05-04,castilla_y_leon,Castilla y León,John Hopkins University,17429,1832,0,537,95,14,0,3,46.0,35.0,30,8662,6935,8153,0.005480558440059902,0.007700770077007757,,0.00561797752808979,0.005338904363973995,0.005072463768115876,0.003693216791825771,17334,1818,0,534,8616,6900,8123
2020-05-04,ceuta,Ceuta,John Hopkins University,101,4,0,4,0,0,0,0,-3.0,3.0,0,-48,145,10,0.0,0.0,,0.0,,0.021126760563380254,0.0,101,4,0,4,-45,142,10
2020-05-04,aragon,Aragón,John Hopkins University,5207,770,0,260,19,8,0,0,-69.0,80.0,13,1733,2704,2539,0.003662297609869025,0.01049868766404205,,0.0,-0.03829078801331853,0.030487804878048808,0.005146476642913678,5188,762,0,260,1802,2624,2526
2020-05-04,pais_vasco,País Vasco,John Hopkins University,12965,1353,0,556,13,12,0,2,-95.0,96.0,17,-639,12251,6736,0.001003705991352577,0.008948545861297452,,0.0036101083032491488,,0.007897984368572697,0.002530138413454397,12952,1341,0,554,-544,12155,6719
2020-05-04,la_rioja,La Rioja,John Hopkins University,3967,336,0,90,6,1,0,2,-28.0,33.0,3,1286,2345,1452,0.0015147689977279555,0.0029850746268655914,,0.022727272727272707,-0.0213089802130898,0.014273356401384163,0.0020703933747412417,3961,335,0,88,1314,2312,1449
2020-05-04,extremadura,Extremadura,John Hopkins University,2852,462,0,108,3,2,0,0,-55.0,56.0,11,244,2146,1629,0.0010530010530009903,0.004347826086956497,,0.0,-0.18394648829431437,0.026794258373205704,0.0067985166872681635,2849,460,0,108,299,2090,1618
2020-05-04,cantabria,Cantabria,John Hopkins University,2207,198,0,79,1,1,0,0,-48.0,48.0,4,351,1658,1015,0.0004533091568450498,0.0050761421319796,,0.0,-0.12030075187969924,0.029813664596273215,0.003956478733926794,2206,197,0,79,399,1610,1011
2020-05-05,castilla-la_mancha,Castilla-La Mancha,John Hopkins University,16144,2647,0,612,64,31,0,3,-5,38,40,7635,5862,8765,0.003980099502487455,0.011850152905198863,,0.0049261083743843415,-0.0006544502617801262,0.006524725274725363,0.004584527220630408,16080,2616,0,609,7640,5824,8725
2020-05-05,navarra,Navarra,John Hopkins University,4966,476,0,135,30,5,0,1,-41,66,10,1862,2628,2005,0.006077795786061602,0.010615711252653925,,0.00746268656716409,-0.02154492905937988,0.025761124121779888,0.005012531328320913,4936,471,0,134,1903,2562,1995
2020-05-05,melilla,Melilla,John Hopkins University,119,2,0,3,0,0,0,0,-3,3,0,13,104,44,0.0,0.0,,0.0,-0.1875,0.02970297029702973,0.0,119,2,0,3,16,101,44
2020-05-05,canarias,Canarias,John Hopkins University,2231,143,0,176,0,1,0,0,-34,33,0,865,1223,920,0.0,0.007042253521126751,,0.0,-0.03781979977753058,0.02773109243697469,0.0,2231,142,0,176,899,1190,920
2020-05-05,baleares,Baleares,John Hopkins University,1919,199,0,167,11,1,0,0,-4,14,12,399,1321,1121,0.005765199161425594,0.005050505050504972,,0.0,-0.00992555831265507,0.010711553175210442,0.010820559062218127,1908,198,0,167,403,1307,1109
2020-05-05,murcia,Murcia,John Hopkins University,1498,136,0,111,2,0,0,0,-82,84,0,-103,1465,650,0.0013368983957218195,0.0,,0.0,,0.06082548877624916,0.0,1496,136,0,111,-21,1381,650
2020-05-05,cataluna,Cataluña,John Hopkins University,50924,5345,0,2871,153,75,0,15,-250,328,340,22698,22881,28085,0.0030135313466348457,0.014231499051233332,,0.005252100840336116,-0.010894195572598964,0.014543519709129704,0.0122544602631105,50771,5270,0,2856,22948,22553,27745
2020-05-05,c_valenciana,C. Valenciana,John Hopkins University,10537,1291,0,701,37,12,0,0,-67,92,11,1499,7747,5225,0.0035238095238094846,0.009382329945269774,,0.0,-0.04278416347381864,0.012018288700196056,0.0021097046413502962,10500,1279,0,701,1566,7655,5214
2020-05-05,asturias,Asturias,John Hopkins University,2322,278,0,120,6,3,0,0,-14,17,7,1091,953,1068,0.002590673575129543,0.01090909090909098,,0.0,-0.012669683257918507,0.018162393162393098,0.006597549481621057,2316,275,0,120,1105,936,1061
2020-05-05,galicia,Galicia,John Hopkins University,8901,588,0,319,20,9,0,2,-230,241,19,1511,6802,2811,0.002251998648800768,0.015544041450777257,,0.006309148264984188,-0.13210798391728895,0.03673220545648537,0.006805157593123168,8881,579,0,317,1741,6561,2792
2020-05-05,madrid,Madrid,John Hopkins University,64781,8466,0,3465,329,46,0,23,-46,329,180,17984,38331,41031,0.005104573946502766,0.005463182897862184,,0.006682161533991815,-0.0025513033832501586,0.008657439082153662,0.004406256884776472,64452,8420,0,3442,18030,38002,40851
2020-05-05,andalucia,Andalucía,John Hopkins University,12190,1281,0,740,23,14,0,2,-440,449,29,3230,7679,6012,0.001890359168241984,0.011049723756906049,,0.0027100271002709064,-0.11989100817438691,0.06210235131396957,0.004847066688951962,12167,1267,0,738,3670,7230,5983
2020-05-05,castilla_y_leon,Castilla y León,John Hopkins University,17520,1847,0,538,91,15,0,1,-25,101,93,8637,7036,8246,0.005221183085661885,0.008187772925764225,,0.0018621973929235924,-0.002886169475871614,0.014563806777216914,0.011406844106463865,17429,1832,0,537,8662,6935,8153
2020-05-05,ceuta,Ceuta,John Hopkins University,109,4,0,4,8,0,0,0,3,5,0,-45,150,10,0.07920792079207928,0.0,,0.0,,0.034482758620689724,0.0,101,4,0,4,-48,145,10
2020-05-05,aragon,Aragón,John Hopkins University,5231,788,0,260,24,18,0,0,-80,86,13,1653,2790,2552,0.004609179950067155,0.023376623376623273,,0.0,-0.0461627236006924,0.031804733727810675,0.005120126033871575,5207,770,0,260,1733,2704,2539
2020-05-05,pais_vasco,País Vasco,John Hopkins University,13008,1364,0,559,43,11,0,3,-466,498,45,-1105,12749,6781,0.00331662167373703,0.008130081300812941,,0.0053956834532373765,,0.0406497428781325,0.00668052256532059,12965,1353,0,556,-639,12251,6736
2020-05-05,la_rioja,La Rioja,John Hopkins University,3980,337,0,91,13,1,0,1,-39,51,6,1247,2396,1458,0.0032770355432316656,0.0029761904761904656,,0.011111111111111072,-0.03032659409020222,0.021748400852878547,0.004132231404958775,3967,336,0,90,1286,2345,1452
2020-05-05,extremadura,Extremadura,John Hopkins University,2865,463,0,108,13,1,0,0,-31,43,21,213,2189,1650,0.004558204768583485,0.0021645021645022577,,0.0,-0.12704918032786883,0.020037278657968338,0.012891344383057168,2852,462,0,108,244,2146,1629
2020-05-05,cantabria,Cantabria,John Hopkins University,2213,199,0,79,6,1,0,0,-33,38,3,318,1696,1018,0.00271862256456723,0.005050505050504972,,0.0,-0.09401709401709402,0.022919179734619988,0.002955665024630516,2207,198,0,79,351,1658,1015
2020-05-06,castilla-la_mancha,Castilla-La Mancha,John Hopkins University,16184,2677,0,613,40,30,0,1,-23.0,33.0,31,7612,5895,8796,0.0024777006937561907,0.011333585190782092,,0.0016339869281045694,-0.003012442698100859,0.005629477993858822,0.0035367940673132203,16144,2647,0,612,7635,5862,8765
2020-05-06,navarra,Navarra,John Hopkins University,4983,480,0,135,17,4,0,0,-91.0,104.0,10,1771,2732,2015,0.003423278292388199,0.008403361344537785,,0.0,-0.048872180451127845,0.03957382039573831,0.004987531172069737,4966,476,0,135,1862,2628,2005
2020-05-06,melilla,Melilla,John Hopkins University,119,2,0,3,0,0,0,0,-4.0,4.0,0,9,108,44,0.0,0.0,,0.0,-0.3076923076923077,0.03846153846153855,0.0,119,2,0,3,13,104,44
2020-05-06,canarias,Canarias,John Hopkins University,2235,144,0,176,4,1,0,0,-32.0,35.0,1,833,1258,921,0.0017929179740026058,0.006993006993007089,,0.0,-0.03699421965317917,0.02861815208503682,0.0010869565217390686,2231,143,0,176,865,1223,920
2020-05-06,baleares,Baleares,John Hopkins University,1927,201,0,167,8,2,0,0,-18.0,24.0,4,381,1345,1125,0.004168837936425307,0.01005025125628145,,0.0,-0.045112781954887216,0.01816805450416359,0.003568242640499486,1919,199,0,167,399,1321,1121
2020-05-06,murcia,Murcia,John Hopkins University,1501,137,0,111,3,1,0,0,-60.0,62.0,2,-163,1527,652,0.0020026702269693164,0.007352941176470562,,0.0,,0.04232081911262808,0.003076923076922977,1498,136,0,111,-103,1465,650
2020-05-06,cataluna,Cataluña,John Hopkins University,51190,5394,0,2891,266,49,0,20,-133.0,350.0,163,22565,23231,28248,0.00522347026942116,0.009167446211412633,,0.006966213862765525,-0.005859547096660478,0.01529653424238453,0.005803809862916065,50924,5345,0,2871,22698,22881,28085
2020-05-06,c_valenciana,C. Valenciana,John Hopkins University,10592,1303,0,704,55,12,0,3,-220.0,263.0,27,1279,8010,5252,0.005219702002467574,0.009295120061967532,,0.004279600570613384,-0.14676450967311538,0.03394862527429976,0.005167464114832487,10537,1291,0,701,1499,7747,5225
2020-05-06,asturias,Asturias,John Hopkins University,2330,279,0,121,8,1,0,1,-11.0,18.0,4,1080,971,1072,0.003445305770887197,0.003597122302158251,,0.008333333333333304,-0.010082493125572856,0.018887722980063026,0.0037453183520599342,2322,278,0,120,1091,953,1068
2020-05-06,galicia,Galicia,John Hopkins University,8919,591,0,320,18,3,0,1,-142.0,157.0,22,1369,6959,2833,0.002022244691607611,0.005102040816326481,,0.0031347962382444194,-0.09397749834546654,0.023081446633343106,0.00782639630024895,8901,588,0,319,1511,6802,2811
2020-05-06,madrid,Madrid,John Hopkins University,65055,8504,0,3485,274,38,0,20,-103.0,339.0,128,17881,38670,41159,0.00422963523255282,0.004488542404913698,,0.005772005772005873,-0.005727313167259829,0.008844016592314263,0.0031195925032292404,64781,8466,0,3465,17984,38331,41031
2020-05-06,andalucia,Andalucía,John Hopkins University,12222,1294,0,742,32,13,0,2,-378.0,397.0,15,2852,8076,6027,0.0026251025430681363,0.010148321623731471,,0.002702702702702675,-0.11702786377708974,0.05169944003125404,0.0024950099800398196,12190,1281,0,740,3230,7679,6012
2020-05-06,castilla_y_leon,Castilla y León,John Hopkins University,17625,1864,0,541,105,17,0,3,-25.0,113.0,54,8612,7149,8300,0.0059931506849315586,0.00920411478072558,,0.005576208178438735,-0.0028945235614218356,0.01606026151222295,0.00654862963861258,17520,1847,0,538,8637,7036,8246
2020-05-06,ceuta,Ceuta,John Hopkins University,109,4,0,4,0,0,0,0,,,0,-45,150,10,0.0,0.0,,0.0,,,0.0,109,4,0,4,-45,150,10
2020-05-06,aragon,Aragón,John Hopkins University,5258,800,0,262,27,12,0,2,-75.0,90.0,12,1578,2880,2564,0.005161536991015181,0.015228426395939021,,0.007692307692307665,-0.04537205081669693,0.032258064516129004,0.004702194357366851,5231,788,0,260,1653,2790,2552
2020-05-06,pais_vasco,País Vasco,John Hopkins University,13041,1383,0,561,33,19,0,2,-307.0,321.0,16,-1412,13070,6797,0.0025369003690036696,0.013929618768328433,,0.003577817531305927,,0.02517844536826419,0.0023595339920365888,13008,1364,0,559,-1105,12749,6781
2020-05-06,la_rioja,La Rioja,John Hopkins University,3986,338,0,91,6,1,0,0,-56.0,61.0,5,1191,2457,1463,0.0015075376884421399,0.0029673590504450953,,0.0,-0.04490777866880513,0.025459098497495836,0.003429355281207025,3980,337,0,91,1247,2396,1458
2020-05-06,extremadura,Extremadura,John Hopkins University,2877,467,0,108,12,4,0,0,-68.0,76.0,14,145,2265,1664,0.004188481675392763,0.008639308855291628,,0.0,-0.31924882629107976,0.03471904979442675,0.00848484848484854,2865,463,0,108,213,2189,1650
2020-05-06,cantabria,Cantabria,John Hopkins University,2220,200,0,79,7,1,0,0,-56.0,62.0,2,262,1758,1020,0.0031631269769543113,0.005025125628140614,,0.0,-0.17610062893081757,0.03655660377358494,0.0019646365422396617,2213,199,0,79,318,1696,1018
2020-05-07,castilla-la_mancha,Castilla-La Mancha,John Hopkins University,16237,2713,0,617,53,36,0,4,-69.0,86.0,32,7543,5981,8828,0.003274839347503722,0.013447889428464643,,0.006525285481239873,-0.009064634787178116,0.0145886344359627,0.0036380172805821065,16184,2677,0,613,7612,5895,8796
2020-05-07,navarra,Navarra,John Hopkins University,5006,484,0,135,23,4,0,0,-76.0,95.0,0,1695,2827,2015,0.004615693357415296,0.008333333333333304,,0.0,-0.042913608130999426,0.0347730600292826,0.0,4983,480,0,135,1771,2732,2015
2020-05-07,melilla,Melilla,John Hopkins University,119,2,0,3,0,0,0,0,,,0,9,108,44,0.0,0.0,,0.0,,,0.0,119,2,0,3,9,108,44
2020-05-07,canarias,Canarias,John Hopkins University,2240,148,0,176,5,4,0,0,-59.0,60.0,6,774,1318,927,0.0022371364653244186,0.02777777777777768,,0.0,-0.07082833133253297,0.04769475357710662,0.006514657980456029,2235,144,0,176,833,1258,921
2020-05-07,baleares,Baleares,John Hopkins University,1933,202,0,167,6,1,0,0,-24.0,29.0,0,357,1374,1125,0.0031136481577582753,0.004975124378109541,,0.0,-0.06299212598425197,0.021561338289962872,0.0,1927,201,0,167,381,1345,1125
2020-05-07,murcia,Murcia,John Hopkins University,1504,137,0,113,3,0,0,2,-132.0,135.0,7,-295,1662,659,0.0019986675549632515,0.0,,0.018018018018018056,,0.08840864440078589,0.010736196319018454,1501,137,0,111,-163,1527,652
2020-05-07,cataluna,Cataluña,John Hopkins University,51733,5471,0,2949,543,77,0,58,33.0,433.0,360,22598,23664,28608,0.010607540535260807,0.014275120504263938,,0.02006226219301288,0.0014624418346997903,0.018638887693168682,0.01274426508071369,51190,5394,0,2891,22565,23231,28248
2020-05-07,c_valenciana,C. Valenciana,John Hopkins University,10619,1309,0,706,27,6,0,2,-150.0,171.0,35,1129,8181,5287,0.0025490936555891963,0.004604758250191798,,0.0028409090909091717,-0.11727912431587173,0.02134831460674147,0.006664127951256704,10592,1303,0,704,1279,8010,5252
2020-05-07,asturias,Asturias,John Hopkins University,2338,280,0,121,8,1,0,0,-5.0,12.0,4,1075,983,1076,0.0034334763948498104,0.0035842293906809264,,0.0,-0.00462962962962965,0.012358393408856916,0.003731343283582156,2330,279,0,121,1080,971,1072
2020-05-07,galicia,Galicia,John Hopkins University,8952,592,0,321,33,1,0,1,-147.0,179.0,19,1222,7138,2852,0.0036999663639420977,0.0016920473773265332,,0.0031250000000000444,-0.10737764791818849,0.025722086506682063,0.006706671373102768,8919,591,0,320,1369,6959,2833
2020-05-07,madrid,Madrid,John Hopkins University,65292,8552,0,3493,237,48,0,8,-116.0,305.0,145,17765,38975,41304,0.003643071247406038,0.005644402634054524,,0.0022955523672882894,-0.006487332923214573,0.007887251099043091,0.003522923297456293,65055,8504,0,3485,17881,38670,41159
2020-05-07,andalucia,Andalucía,John Hopkins University,12239,1301,0,742,17,7,0,0,-349.0,359.0,11,2503,8435,6038,0.0013909343806250973,0.005409582689335446,,0.0,-0.12237026647966343,0.044452699356116954,0.0018251202920192,12222,1294,0,742,2852,8076,6027
2020-05-07,castilla_y_leon,Castilla y León,John Hopkins University,17716,1876,0,543,91,12,0,2,-3.0,82.0,57,8609,7231,8357,0.0051631205673758895,0.006437768240343367,,0.003696857670979714,-0.0003483511379470672,0.011470135683312455,0.00686746987951814,17625,1864,0,541,8612,7149,8300
2020-05-07,ceuta,Ceuta,John Hopkins University,109,4,0,4,0,0,0,0,-4.0,4.0,1,-49,154,11,0.0,0.0,,0.0,,0.026666666666666616,0.10000000000000009,109,4,0,4,-45,150,10
2020-05-07,aragon,Aragón,John Hopkins University,5274,815,0,263,16,15,0,1,-72.0,73.0,14,1506,2953,2578,0.003042982122479998,0.018750000000000044,,0.003816793893129722,-0.04562737642585546,0.025347222222222188,0.00546021840873645,5258,800,0,262,1578,2880,2564
2020-05-07,pais_vasco,País Vasco,John Hopkins University,13101,1390,0,566,60,7,0,5,-417.0,470.0,21,-1829,13540,6818,0.004600874166091451,0.005061460592914013,,0.00891265597147961,,0.03596021423106355,0.003089598352214118,13041,1383,0,561,-1412,13070,6797
2020-05-07,la_rioja,La Rioja,John Hopkins University,3992,342,0,91,6,4,0,0,-67.0,69.0,6,1124,2526,1469,0.0015052684395384652,0.01183431952662728,,0.0,-0.056255247691015975,0.028083028083027983,0.004101161995898828,3986,338,0,91,1191,2457,1463
2020-05-07,extremadura,Extremadura,John Hopkins University,2900,472,0,109,23,5,0,1,-29.0,47.0,14,116,2312,1678,0.00799443865137306,0.010706638115631772,,0.0092592592592593,-0.19999999999999996,0.020750551876379753,0.008413461538461453,2877,467,0,108,145,2265,1664
2020-05-07,cantabria,Cantabria,John Hopkins University,2232,201,0,79,12,1,0,0,-17.0,28.0,2,245,1786,1022,0.00540540540540535,0.004999999999999893,,0.0,-0.06488549618320616,0.015927189988623525,0.0019607843137254832,2220,200,0,79,262,1758,1020
2020-05-08,castilla-la_mancha,Castilla-La Mancha,John Hopkins University,16278,2738,0,621,41,25,0,4,-65.0,81.0,39,7478,6062,8867,0.0025250970006773787,0.009214891264283098,,0.006482982171799101,-0.008617261036722779,0.013542885805049254,0.0044177616674219156,16237,2713,0,617,7543,5981,8828
2020-05-08,navarra,Navarra,John Hopkins University,5039,487,0,135,33,3,0,0,-60.0,90.0,6,1635,2917,2021,0.00659208949260881,0.006198347107438051,,0.0,-0.03539823008849563,0.031835868411743906,0.0029776674937964653,5006,484,0,135,1695,2827,2015
2020-05-08,melilla,Melilla,John Hopkins University,119,2,0,3,0,0,0,0,,,0,9,108,44,0.0,0.0,,0.0,,,0.0,119,2,0,3,9,108,44
2020-05-08,canarias,Canarias,John Hopkins University,2250,148,0,178,10,0,0,2,-14.0,24.0,8,760,1342,935,0.0044642857142858094,0.0,,0.011363636363636465,-0.018087855297157618,0.018209408194233667,0.008629989212513456,2240,148,0,176,774,1318,927
2020-05-08,baleares,Baleares,John Hopkins University,1942,207,0,168,9,5,0,1,-17.0,21.0,0,340,1395,1125,0.004655975168132542,0.024752475247524774,,0.0059880239520957446,-0.04761904761904767,0.015283842794759916,0.0,1933,202,0,167,357,1374,1125
2020-05-08,murcia,Murcia,John Hopkins University,1506,138,0,113,2,1,0,0,-104.0,105.0,3,-399,1767,662,0.0013297872340425343,0.007299270072992803,,0.0,,0.06317689530685922,0.004552352048558417,1504,137,0,113,-295,1662,659
2020-05-08,cataluna,Cataluña,John Hopkins University,51935,5507,0,2950,202,36,0,1,-233.0,399.0,79,22365,24063,28687,0.0039046643341773546,0.00658014988119171,,0.0003390979993218579,-0.01031064695990791,0.016861054766734274,0.0027614653243848153,51733,5471,0,2949,22598,23664,28608
2020-05-08,c_valenciana,C. Valenciana,John Hopkins University,10661,1315,0,709,42,6,0,3,-579.0,615.0,30,550,8796,5317,0.0039551746868820015,0.004583651642475095,,0.004249291784702569,-0.5128432240921169,0.07517418408507526,0.005674295441649324,10619,1309,0,706,1129,8181,5287
2020-05-08,asturias,Asturias,John Hopkins University,2344,280,0,121,6,0,0,0,-23.0,29.0,1,1052,1012,1077,0.0025662959794696683,0.0,,0.0,-0.021395348837209283,0.029501525940996975,0.0009293680297397522,2338,280,0,121,1075,983,1076
2020-05-08,galicia,Galicia,John Hopkins University,8964,595,0,323,12,3,0,2,-78.0,87.0,24,1144,7225,2876,0.0013404825737264314,0.0050675675675675436,,0.006230529595015577,-0.06382978723404253,0.012188288035864359,0.008415147265077083,8952,592,0,321,1222,7138,2852
2020-05-08,madrid,Madrid,John Hopkins University,65513,8598,0,3508,221,46,0,15,-77.0,252.0,132,17688,39227,41436,0.0033847944618023984,0.005378858746492021,,0.004294302891497237,-0.004334365325077361,0.006465683130211675,0.0031958163858221145,65292,8552,0,3493,17765,38975,41304
2020-05-08,andalucia,Andalucía,John Hopkins University,12250,1317,0,745,11,16,0,3,-349.0,344.0,31,2154,8779,6069,0.0008987662390718132,0.012298232129131392,,0.0040431266846361336,-0.13943268078306037,0.040782454060462436,0.005134150380920799,12239,1301,0,742,2503,8435,6038
2020-05-08,castilla_y_leon,Castilla y León,John Hopkins University,17822,1885,0,546,106,9,0,3,11.0,86.0,37,8620,7317,8394,0.0059832919394897655,0.00479744136460547,,0.005524861878453136,0.0012777326054129734,0.011893237449868588,0.004427426109848032,17716,1876,0,543,8609,7231,8357
2020-05-08,ceuta,Ceuta,John Hopkins University,110,4,0,4,1,0,0,0,1.0,,0,-48,154,11,0.00917431192660545,0.0,,0.0,,,0.0,109,4,0,4,-49,154,11
2020-05-08,aragon,Aragón,John Hopkins University,5291,823,0,263,17,8,0,0,-44.0,53.0,5,1462,3006,2583,0.0032233598786499673,0.009815950920245342,,0.0,-0.02921646746347939,0.017947849644429414,0.0019394879751746252,5274,815,0,263,1506,2953,2578
2020-05-08,pais_vasco,País Vasco,John Hopkins University,13111,1403,0,568,10,13,0,2,-448.0,445.0,47,-2277,13985,6865,0.00076330051141138,0.009352517985611541,,0.0035335689045936647,,0.03286558345642532,0.006893517160457607,13101,1390,0,566,-1829,13540,6818
2020-05-08,la_rioja,La Rioja,John Hopkins University,4000,344,0,91,8,2,0,0,-49.0,55.0,4,1075,2581,1473,0.002004008016031955,0.005847953216374213,,0.0,-0.04359430604982206,0.021773555027711833,0.002722940776038074,3992,342,0,91,1124,2526,1469
2020-05-08,extremadura,Extremadura,John Hopkins University,2907,477,0,109,7,5,0,0,-40.0,42.0,17,76,2354,1695,0.0024137931034482474,0.010593220338983134,,0.0,-0.3448275862068966,0.018166089965397925,0.010131108462455352,2900,472,0,109,116,2312,1678
2020-05-08,cantabria,Cantabria,John Hopkins University,2241,201,0,79,9,0,0,0,-67.0,76.0,1,178,1862,1023,0.0040322580645162365,0.0,,0.0,-0.273469387755102,0.042553191489361764,0.0009784735812132794,2232,201,0,79,245,1786,1022
2020-05-09,castilla-la_mancha,Castilla-La Mancha,John Hopkins University,16343,2759,0,623,65,21,0,2,-23.0,67.0,28,7455,6129,8895,0.003993119547855972,0.007669831994156384,,0.0032206119162641045,-0.003075688686814626,0.01105245793467513,0.0031577760234577923,16278,2738,0,621,7478,6062,8867
2020-05-09,navarra,Navarra,John Hopkins University,5052,488,0,135,13,1,0,0,-85.0,97.0,2,1550,3014,2023,0.002579876959714289,0.002053388090349051,,0.0,-0.051987767584097844,0.033253342475145775,0.0009896091044037103,5039,487,0,135,1635,2917,2021
2020-05-09,melilla,Melilla,John Hopkins University,119,2,0,3,0,0,0,0,-3.0,3.0,0,6,111,44,0.0,0.0,,0.0,-0.33333333333333337,0.02777777777777768,0.0,119,2,0,3,9,108,44
2020-05-09,canarias,Canarias,John Hopkins University,2258,148,0,178,8,0,0,0,4.0,4.0,0,764,1346,935,0.003555555555555534,0.0,,0.0,0.0052631578947368585,0.0029806259314455463,0.0,2250,148,0,178,760,1342,935
2020-05-09,baleares,Baleares,John Hopkins University,1948,209,0,168,6,2,0,0,-2.0,6.0,0,338,1401,1125,0.003089598352214118,0.009661835748792313,,0.0,-0.00588235294117645,0.004301075268817289,0.0,1942,207,0,168,340,1395,1125
2020-05-09,murcia,Murcia,John Hopkins University,1508,139,0,113,2,1,0,0,-14.0,15.0,0,-413,1782,662,0.0013280212483399723,0.007246376811594235,,0.0,,0.008488964346349714,0.0,1506,138,0,113,-399,1767,662
2020-05-09,cataluna,Cataluña,John Hopkins University,52162,5532,0,2951,227,25,0,1,-84.0,286.0,97,22281,24349,28784,0.004370848175604181,0.004539676775013657,,0.0003389830508475633,-0.003755868544600971,0.01188546731496487,0.003381322550284116,51935,5507,0,2950,22365,24063,28687
2020-05-09,c_valenciana,C. Valenciana,John Hopkins University,10713,1323,0,716,52,8,0,7,-21.0,65.0,37,529,8861,5354,0.00487759122033582,0.006083650190114032,,0.009873060648801113,-0.038181818181818206,0.007389722601182314,0.006958811359789374,10661,1315,0,709,550,8796,5317
2020-05-09,asturias,Asturias,John Hopkins University,2346,283,0,121,2,3,0,0,-11.0,10.0,3,1041,1022,1080,0.0008532423208191808,0.010714285714285676,,0.0,-0.010456273764258506,0.009881422924901129,0.0027855153203342198,2344,280,0,121,1052,1012,1077
2020-05-09,galicia,Galicia,John Hopkins University,8981,596,0,325,17,1,0,2,-106.0,122.0,10,1038,7347,2886,0.0018964747880410027,0.001680672268907557,,0.006191950464396356,-0.09265734265734271,0.01688581314878901,0.003477051460361702,8964,595,0,323,1144,7225,2876
2020-05-09,madrid,Madrid,John Hopkins University,65598,8644,0,3520,85,46,0,12,-263.0,302.0,123,17425,39529,41559,0.0012974524140247912,0.005350081414282393,,0.003420752565564511,-0.014868837630031662,0.0076987789022866515,0.002968433246452351,65513,8598,0,3508,17688,39227,41436
2020-05-09,andalucia,Andalucía,John Hopkins University,12267,1320,0,745,17,3,0,0,-227.0,241.0,11,1927,9020,6080,0.0013877551020409218,0.002277904328018332,,0.0,-0.1053853296193129,0.027451873789725578,0.0018124897017630648,12250,1317,0,745,2154,8779,6069
2020-05-09,castilla_y_leon,Castilla y León,John Hopkins University,17952,1897,0,546,130,12,0,0,6.0,112.0,74,8626,7429,8468,0.007294355291213028,0.006366047745357983,,0.0,0.0006960556844548549,0.01530681973486403,0.008815820824398468,17822,1885,0,546,8620,7317,8394
2020-05-09,ceuta,Ceuta,John Hopkins University,110,4,0,4,0,0,0,0,,,0,-48,154,11,0.0,0.0,,0.0,,,0.0,110,4,0,4,-48,154,11
2020-05-09,aragon,Aragón,John Hopkins University,5316,824,0,263,25,1,0,0,-46.0,70.0,5,1416,3076,2588,0.0047250047250047,0.0012150668286756705,,0.0,-0.03146374829001364,0.02328675981370587,0.0019357336430507743,5291,823,0,263,1462,3006,2583
2020-05-09,pais_vasco,País Vasco,John Hopkins University,13156,1418,0,571,45,15,0,3,-631.0,661.0,37,-2908,14646,6902,0.0034322324765463375,0.010691375623663513,,0.005281690140845008,,0.047264926707186294,0.00538965768390387,13111,1403,0,568,-2277,13985,6865
2020-05-09,la_rioja,La Rioja,John Hopkins University,4008,346,0,91,8,2,0,0,-61.0,67.0,1,1014,2648,1474,0.0020000000000000018,0.005813953488372103,,0.0,-0.05674418604651166,0.025958930647036027,0.0006788866259335169,4000,344,0,91,1075,2581,1473
2020-05-09,extremadura,Extremadura,John Hopkins University,2912,480,0,109,5,3,0,0,-13.0,15.0,16,63,2369,1711,0.0017199862401100496,0.0062893081761006275,,0.0,-0.17105263157894735,0.006372132540356734,0.00943952802359882,2907,477,0,109,76,2354,1695
2020-05-09,cantabria,Cantabria,John Hopkins University,2244,201,0,79,3,0,0,0,-68.0,71.0,4,110,1933,1027,0.0013386880856760541,0.0,,0.0,-0.3820224719101124,0.038131041890440365,0.003910068426197455,2241,201,0,79,178,1862,1023
2020-05-10,castilla-la_mancha,Castilla-La Mancha,John Hopkins University,16387,2786,0,624,44,27,0,1,-26.0,43.0,23,7429,6172,8918,0.002692284158355207,0.009786154403769398,,0.0016051364365972098,-0.003487592219986624,0.007015826399086267,0.0025857223159078124,16343,2759,0,623,7455,6129,8895
2020-05-10,navarra,Navarra,John Hopkins University,5065,490,0,135,13,2,0,0,-45.0,56.0,6,1505,3070,2029,0.00257323832145695,0.004098360655737654,,0.0,-0.029032258064516148,0.01857996018579966,0.002965892239248591,5052,488,0,135,1550,3014,2023
2020-05-10,melilla,Melilla,John Hopkins University,119,2,0,3,0,0,0,0,-2.0,2.0,0,4,113,44,0.0,0.0,,0.0,-0.33333333333333337,0.018018018018018056,0.0,119,2,0,3,6,111,44
2020-05-10,canarias,Canarias,John Hopkins University,2260,149,0,178,2,1,0,0,-44.0,45.0,1,720,1391,936,0.0008857395925598865,0.006756756756756799,,0.0,-0.05759162303664922,0.03343239227340278,0.0010695187165774556,2258,148,0,178,764,1346,935
2020-05-10,baleares,Baleares,John Hopkins University,1951,209,0,168,3,0,0,0,-11.0,14.0,0,327,1415,1125,0.0015400410677617327,0.0,,0.0,-0.03254437869822491,0.009992862241256173,0.0,1948,209,0,168,338,1401,1125
2020-05-10,murcia,Murcia,John Hopkins University,1517,139,0,113,9,0,0,0,5.0,4.0,3,-408,1786,665,0.005968169761273234,0.0,,0.0,,0.002244668911335568,0.004531722054380571,1508,139,0,113,-413,1782,662
2020-05-10,cataluna,Cataluña,John Hopkins University,54807,5555,0,2952,2645,23,0,1,2517.0,105.0,36,24798,24454,28820,0.05070741152563163,0.0041576283441793205,,0.0003388681802778404,0.11296620438938998,0.004312292085917324,0.001250694830461363,52162,5532,0,2951,22281,24349,28784
2020-05-10,c_valenciana,C. Valenciana,John Hopkins University,10729,1330,0,716,16,7,0,0,-75.0,84.0,1,454,8945,5355,0.0014935125548398709,0.005291005291005346,,0.0,-0.14177693761814747,0.009479742692698245,0.00018677624206198118,10713,1323,0,716,529,8861,5354
2020-05-10,asturias,Asturias,John Hopkins University,2350,288,0,121,4,5,0,0,-5.0,4.0,0,1036,1026,1080,0.0017050298380221207,0.0176678445229681,,0.0,-0.004803073967339144,0.00391389432485334,0.0,2346,283,0,121,1041,1022,1080
2020-05-10,galicia,Galicia,John Hopkins University,8999,597,0,326,18,1,0,1,-81.0,98.0,16,957,7445,2902,0.0020042311546597524,0.001677852348993314,,0.003076923076922977,-0.0780346820809249,0.01333877773240788,0.00554400554400547,8981,596,0,325,1038,7347,2886
2020-05-10,madrid,Madrid,John Hopkins University,65650,8683,0,3529,52,39,0,9,-62.0,75.0,91,17363,39604,41650,0.0007927070947284509,0.0045118000925497,,0.002556818181818077,-0.0035581061692969707,0.0018973411925422567,0.002189658076469536,65598,8644,0,3520,17425,39529,41559
2020-05-10,andalucia,Andalucía,John Hopkins University,12285,1322,0,745,18,2,0,0,-169.0,185.0,12,1758,9205,6092,0.0014673514306675628,0.0015151515151514694,,0.0,-0.0877010897768552,0.020509977827050996,0.0019736842105262387,12267,1320,0,745,1927,9020,6080
2020-05-10,castilla_y_leon,Castilla y León,John Hopkins University,17995,1905,0,547,43,8,0,1,11.0,24.0,14,8637,7453,8482,0.002395276292335158,0.004217185028993153,,0.001831501831501825,0.0012752144678878086,0.0032305828509893164,0.0016532829475672806,17952,1897,0,546,8626,7429,8468
2020-05-10,ceuta,Ceuta,John Hopkins University,110,4,0,4,0,0,0,0,,,0,-48,154,11,0.0,0.0,,0.0,,,0.0,110,4,0,4,-48,154,11
2020-05-10,aragon,Aragón,John Hopkins University,5336,825,0,263,20,1,0,0,-21.0,40.0,7,1395,3116,2595,0.003762227238525151,0.0012135922330096527,,0.0,-0.014830508474576232,0.013003901170351106,0.002704791344667612,5316,824,0,263,1416,3076,2588
2020-05-10,pais_vasco,País Vasco,John Hopkins University,13167,1423,0,573,11,5,0,2,-66.0,72.0,20,-2974,14718,6922,0.0008361204013378476,0.0035260930888576514,,0.003502626970227629,,0.004916018025399316,0.002897710808461351,13156,1418,0,571,-2908,14646,6902
2020-05-10,la_rioja,La Rioja,John Hopkins University,4008,346,0,91,0,0,0,0,-52.0,52.0,1,962,2700,1475,0.0,0.0,,0.0,-0.05128205128205132,0.01963746223564944,0.0006784260515604323,4008,346,0,91,1014,2648,1474
2020-05-10,extremadura,Extremadura,John Hopkins University,2918,483,0,109,6,3,0,0,-37.0,40.0,14,26,2409,1725,0.002060439560439553,0.006250000000000089,,0.0,-0.5873015873015873,0.016884761502743872,0.008182349503214503,2912,480,0,109,63,2369,1711
2020-05-10,cantabria,Cantabria,John Hopkins University,2245,201,0,79,1,0,0,0,-29.0,30.0,0,81,1963,1027,0.00044563279857401383,0.0,,0.0,-0.26363636363636367,0.015519917227108104,0.0,2244,201,0,79,110,1933,1027
2020-05-11,castilla-la_mancha,Castilla-La Mancha,John Hopkins University,16431,2811,0,629,44,25,0,5,10,9.0,22,7439,6181,8940,0.002685055226704147,0.008973438621679763,,0.008012820512820484,0.0013460761879122707,0.0014581983149708488,0.002466920834267805,16387,2786,0,624,7429,6172,8918
2020-05-11,navarra,Navarra,John Hopkins University,5081,493,0,135,16,3,0,0,-72,85.0,10,1433,3155,2039,0.003158933859822355,0.00612244897959191,,0.0,-0.04784053156146184,0.027687296416938123,0.00492853622474132,5065,490,0,135,1505,3070,2029
2020-05-11,melilla,Melilla,John Hopkins University,119,2,0,3,0,0,0,0,-2,2.0,0,2,115,44,0.0,0.0,,0.0,-0.5,0.017699115044247815,0.0,119,2,0,3,4,113,44
2020-05-11,canarias,Canarias,John Hopkins University,2268,151,0,178,8,2,0,0,-59,65.0,1,661,1456,937,0.003539823008849474,0.01342281879194629,,0.0,-0.08194444444444449,0.04672897196261672,0.0010683760683760646,2260,149,0,178,720,1391,936
2020-05-11,baleares,Baleares,John Hopkins University,1951,210,0,169,0,1,0,1,-9,8.0,1,318,1423,1126,0.0,0.004784688995215225,,0.005952380952380931,-0.02752293577981646,0.00565371024734973,0.000888888888888939,1951,209,0,168,327,1415,1125
2020-05-11,murcia,Murcia,John Hopkins University,1517,139,0,112,0,0,0,-1,-33,33.0,0,-441,1819,665,0.0,0.0,,-0.008849557522123908,,0.018477043673012394,0.0,1517,139,0,113,-408,1786,665
2020-05-11,cataluna,Cataluña,John Hopkins University,55144,5621,0,2952,337,66,0,0,-241,512.0,318,24557,24966,29138,0.006148849599503681,0.011881188118811892,,0.0,-0.00971852568755549,0.02093726997628198,0.01103400416377509,54807,5555,0,2952,24798,24454,28820
2020-05-11,c_valenciana,C. Valenciana,John Hopkins University,10740,1336,0,717,11,6,0,1,-139,144.0,5,315,9089,5360,0.0010252586447945244,0.004511278195488799,,0.0013966480446927498,-0.3061674008810573,0.016098378982671857,0.0009337068160597539,10729,1330,0,716,454,8945,5355
2020-05-11,asturias,Asturias,John Hopkins University,2352,290,0,121,2,2,0,0,-5,5.0,0,1031,1031,1080,0.0008510638297871687,0.00694444444444442,,0.0,-0.004826254826254872,0.004873294346978474,0.0,2350,288,0,121,1036,1026,1080
2020-05-11,galicia,Galicia,John Hopkins University,9003,598,0,326,4,1,0,0,-372,375.0,3,585,7820,2905,0.00044449383264799636,0.0016750418760469454,,0.0,-0.3887147335423198,0.05036937541974473,0.001033769813921337,8999,597,0,326,957,7445,2902
2020-05-11,madrid,Madrid,John Hopkins University,65839,8720,0,3543,189,37,0,14,5,147.0,85,17368,39751,41735,0.002878903274942779,0.004261200046067115,,0.0039671294984415795,0.0002879686690087091,0.003711746288253659,0.0020408163265306367,65650,8683,0,3529,17363,39604,41650
2020-05-11,andalucia,Andalucía,John Hopkins University,12293,1326,0,745,8,4,0,0,-88,92.0,9,1670,9297,6101,0.0006512006512007229,0.00302571860816947,,0.0,-0.05005688282138798,0.009994568169473084,0.0014773473407747595,12285,1322,0,745,1758,9205,6092
2020-05-11,castilla_y_leon,Castilla y León,John Hopkins University,18048,1914,0,547,53,9,0,0,25,19.0,11,8662,7472,8493,0.002945262572936924,0.0047244094488188,,0.0,0.0028945235614217246,0.00254930900308592,0.001296863947182203,17995,1905,0,547,8637,7453,8482
2020-05-11,ceuta,Ceuta,John Hopkins University,114,4,0,4,4,0,0,0,4,,0,-44,154,11,0.036363636363636376,0.0,,0.0,,,0.0,110,4,0,4,-48,154,11
2020-05-11,aragon,Aragón,John Hopkins University,5359,828,0,264,23,3,0,1,-50,70.0,11,1345,3186,2606,0.004310344827586299,0.0036363636363636598,,0.0038022813688212143,-0.03584229390681004,0.0224646983311938,0.004238921001926688,5336,825,0,263,1395,3116,2595
2020-05-11,pais_vasco,País Vasco,John Hopkins University,13176,1429,0,574,9,6,0,1,-192,195.0,7,-3166,14913,6929,0.0006835269993163973,0.0042164441321153046,,0.0017452006980802626,,0.01324908275580916,0.0010112684195320298,13167,1423,0,573,-2974,14718,6922
2020-05-11,la_rioja,La Rioja,John Hopkins University,4008,347,0,91,0,1,0,0,-50,49.0,3,912,2749,1478,0.0,0.0028901734104045396,,0.0,-0.05197505197505192,0.018148148148148247,0.0020338983050847137,4008,346,0,91,962,2700,1475
2020-05-11,extremadura,Extremadura,John Hopkins University,2919,487,0,109,1,4,0,0,-16,13.0,12,10,2422,1737,0.00034270047978068874,0.008281573498964745,,0.0,-0.6153846153846154,0.005396430053964396,0.006956521739130528,2918,483,0,109,26,2409,1725
2020-05-11,cantabria,Cantabria,John Hopkins University,2246,203,0,79,1,2,0,0,-19,18.0,0,62,1981,1027,0.00044543429844101645,0.00995024875621886,,0.0,-0.23456790123456794,0.009169638308711203,0.0,2245,201,0,79,81,1963,1027
2020-05-12,castilla-la_mancha,Castilla-La Mancha,John Hopkins University,16453,2835,0,632,22,24,0,3,-26.0,24.0,23,7413,6205,8963,0.0013389325056296641,0.008537886872998834,,0.004769475357710551,-0.003495093426535867,0.003882866850024369,0.0025727069351231258,16431,2811,0,629,7439,6181,8940
2020-05-12,navarra,Navarra,John Hopkins University,5094,494,0,135,13,1,0,0,-130.0,142.0,3,1303,3297,2042,0.002558551466246728,0.0020283975659229903,,0.0,-0.09071877180739707,0.04500792393026942,0.0014713094654241754,5081,493,0,135,1433,3155,2039
2020-05-12,melilla,Melilla,John Hopkins University,119,2,0,3,0,0,0,0,,,0,2,115,44,0.0,0.0,,0.0,,,0.0,119,2,0,3,2,115,44
2020-05-12,canarias,Canarias,John Hopkins University,2271,151,0,178,3,0,0,0,-16.0,19.0,0,645,1475,937,0.001322751322751392,0.0,,0.0,-0.024205748865355536,0.013049450549450503,0.0,2268,151,0,178,661,1456,937
2020-05-12,baleares,Baleares,John Hopkins University,1955,215,0,171,4,5,0,2,-43.0,42.0,5,275,1465,1131,0.002050230650948226,0.023809523809523725,,0.01183431952662728,-0.1352201257861635,0.029515108924806688,0.00444049733570151,1951,210,0,169,318,1423,1126
2020-05-12,murcia,Murcia,John Hopkins University,1525,142,0,112,8,3,0,0,-37.0,42.0,1,-478,1861,666,0.005273566249176076,0.021582733812949728,,0.0,,0.023089609675645884,0.0015037593984963404,1517,139,0,112,-441,1819,665
2020-05-12,cataluna,Cataluña,John Hopkins University,55287,5692,0,2953,143,71,0,1,-288.0,360.0,129,24269,25326,29267,0.0025932105034092157,0.012631204412026253,,0.0003387533875338633,-0.011727816915747091,0.014419610670511895,0.004427208456311282,55144,5621,0,2952,24557,24966,29138
2020-05-12,c_valenciana,C. Valenciana,John Hopkins University,10760,1341,0,717,20,5,0,0,-164.0,179.0,10,151,9268,5370,0.0018621973929235924,0.0037425149700598404,,0.0,-0.5206349206349206,0.019694135768511423,0.001865671641791078,10740,1336,0,717,315,9089,5360
2020-05-12,asturias,Asturias,John Hopkins University,2356,292,0,121,4,2,0,0,-5.0,7.0,0,1026,1038,1080,0.001700680272108901,0.006896551724137945,,0.0,-0.004849660523763344,0.00678952473326877,0.0,2352,290,0,121,1031,1031,1080
2020-05-12,galicia,Galicia,John Hopkins University,9014,599,0,327,11,1,0,1,-166.0,176.0,4,419,7996,2909,0.0012218149505720532,0.0016722408026756952,,0.0030674846625766694,-0.28376068376068375,0.02250639386189257,0.001376936316695332,9003,598,0,326,585,7820,2905
2020-05-12,madrid,Madrid,John Hopkins University,66058,8760,0,3555,219,40,0,12,-54.0,233.0,121,17314,39984,41856,0.0033262959643980405,0.004587155963302836,,0.003386960203217715,-0.003109166282818987,0.005861487761314121,0.002899245237810044,65839,8720,0,3543,17368,39751,41735
2020-05-12,andalucia,Andalucía,John Hopkins University,12317,1332,0,750,24,6,0,5,-166.0,184.0,13,1504,9481,6114,0.001952330594647389,0.004524886877828038,,0.006711409395973256,-0.09940119760479038,0.01979133053673232,0.0021307982297984474,12293,1326,0,745,1670,9297,6101
2020-05-12,castilla_y_leon,Castilla y León,John Hopkins University,18105,1919,0,547,57,5,0,0,-20.0,72.0,24,8642,7544,8517,0.00315824468085113,0.002612330198537016,,0.0,-0.0023089355806973355,0.009635974304068595,0.0028258565877781194,18048,1914,0,547,8662,7472,8493
2020-05-12,ceuta,Ceuta,John Hopkins University,114,4,0,4,0,0,0,0,-2.0,2.0,0,-46,156,11,0.0,0.0,,0.0,,0.01298701298701288,0.0,114,4,0,4,-44,154,11
2020-05-12,aragon,Aragón,John Hopkins University,5372,829,0,265,13,1,0,1,-114.0,126.0,8,1231,3312,2614,0.002425825713752605,0.0012077294685990392,,0.0037878787878788955,-0.08475836431226769,0.039548022598870025,0.003069838833461347,5359,828,0,264,1345,3186,2606
2020-05-12,pais_vasco,País Vasco,John Hopkins University,13214,1442,0,575,38,13,0,1,-48.0,73.0,26,-3214,14986,6955,0.0028840315725562338,0.009097270818754444,,0.0017421602787457413,,0.004895058003084651,0.0037523452157599557,13176,1429,0,574,-3166,14913,6929
2020-05-12,la_rioja,La Rioja,John Hopkins University,4009,348,0,91,1,1,0,0,-55.0,55.0,3,857,2804,1481,0.00024950099800391534,0.0028818443804035088,,0.0,-0.0603070175438597,0.020007275372862843,0.002029769959404515,4008,347,0,91,912,2749,1478
2020-05-12,extremadura,Extremadura,John Hopkins University,2919,489,0,109,0,2,0,0,-36.0,34.0,17,-26,2456,1754,0.0,0.004106776180698102,,0.0,-3.6,0.014037985136251097,0.00978698906160047,2919,487,0,109,10,2422,1737
2020-05-12,cantabria,Cantabria,John Hopkins University,2256,205,0,79,10,2,0,0,-65.0,73.0,2,-3,2054,1029,0.0044523597506678225,0.009852216748768461,,0.0,-1.0483870967741935,0.03685007571933374,0.0019474196689386325,2246,203,0,79,62,1981,1027
2020-05-13,castilla-la_mancha,Castilla-La Mancha,John Hopkins University,16470,2852,0,634,17,17,0,2,-39,39,17,7374,6244,8980,0.0010332462164954759,0.005996472663139407,,0.0031645569620253333,-0.005261027923917472,0.006285253827558401,0.0018966863773290932,16453,2835,0,632,7413,6205,8963
2020-05-13,navarra,Navarra,John Hopkins University,5105,498,0,135,11,4,0,0,-96,103,3,1207,3400,2045,0.002159403219473832,0.00809716599190291,,0.0,-0.07367613200306988,0.031240521686381584,0.0014691478942212566,5094,494,0,135,1303,3297,2042
2020-05-13,melilla,Melilla,John Hopkins University,119,2,0,3,0,0,0,0,-4,4,0,-2,119,44,0.0,0.0,,0.0,-2.0,0.034782608695652195,0.0,119,2,0,3,2,115,44
2020-05-13,canarias,Canarias,John Hopkins University,2275,151,0,178,4,0,0,0,-17,21,0,628,1496,937,0.001761338617349173,0.0,,0.0,-0.02635658914728678,0.014237288135593218,0.0,2271,151,0,178,645,1475,937
2020-05-13,baleares,Baleares,John Hopkins University,1956,216,0,171,1,1,0,0,-27,27,0,248,1492,1131,0.000511508951406725,0.0046511627906977715,,0.0,-0.09818181818181815,0.018430034129692796,0.0,1955,215,0,171,275,1465,1131
2020-05-13,murcia,Murcia,John Hopkins University,1532,142,0,112,7,0,0,0,-130,137,6,-608,1998,672,0.004590163934426128,0.0,,0.0,,0.07361633530360012,0.009009009009008917,1525,142,0,112,-478,1861,666
2020-05-13,cataluna,Cataluña,John Hopkins University,55313,5823,0,2954,26,131,0,1,-628,523,38,23641,25849,29305,0.0004702733011376914,0.02301475755446236,,0.00033863867253636215,-0.02587663274135732,0.020650714680565452,0.0012983906789216793,55287,5692,0,2953,24269,25326,29267
2020-05-13,c_valenciana,C. Valenciana,John Hopkins University,10784,1349,0,717,24,8,0,0,-206,222,19,-55,9490,5389,0.0022304832713755385,0.005965697240865042,,0.0,-1.3642384105960264,0.023953388001726417,0.003538175046554848,10760,1341,0,717,151,9268,5370
2020-05-13,asturias,Asturias,John Hopkins University,2357,293,0,121,1,1,0,0,-8,8,4,1018,1046,1084,0.0004244482173174635,0.003424657534246478,,0.0,-0.007797270955165692,0.007707129094412402,0.0037037037037037646,2356,292,0,121,1026,1038,1080
2020-05-13,galicia,Galicia,John Hopkins University,9030,603,0,327,16,4,0,0,-149,161,6,270,8157,2915,0.0017750166407810575,0.006677796327211993,,0.0,-0.3556085918854416,0.020135067533766815,0.002062564455139304,9014,599,0,327,419,7996,2909
2020-05-13,madrid,Madrid,John Hopkins University,66262,8779,0,3564,204,19,0,9,-30,215,106,17284,40199,41962,0.003088195222380241,0.0021689497716894657,,0.0025316455696202667,-0.0017327018597667054,0.005377150860344182,0.002532492354740068,66058,8760,0,3555,17314,39984,41856
2020-05-13,andalucia,Andalucía,John Hopkins University,12359,1336,0,751,42,4,0,1,-399,437,14,1105,9918,6128,0.0034099212470568574,0.0030030030030030463,,0.0013333333333334085,-0.26529255319148937,0.04609218436873741,0.0022898266274125056,12317,1332,0,750,1504,9481,6114
2020-05-13,castilla_y_leon,Castilla y León,John Hopkins University,18173,1925,0,548,68,6,0,1,-15,77,43,8627,7621,8560,0.00375586854460086,0.0031266284523188137,,0.001828153564899404,-0.0017357093265447654,0.010206786850477156,0.0050487260772571485,18105,1919,0,547,8642,7544,8517
2020-05-13,ceuta,Ceuta,John Hopkins University,116,4,0,4,2,0,0,0,-1,3,0,-47,159,11,0.01754385964912286,0.0,,0.0,,0.019230769230769162,0.0,114,4,0,4,-46,156,11
2020-05-13,aragon,Aragón,John Hopkins University,5389,836,0,265,17,7,0,0,-149,159,11,1082,3471,2625,0.0031645569620253333,0.008443908323281013,,0.0,-0.12103980503655565,0.04800724637681153,0.004208110175975444,5372,829,0,265,1231,3312,2614
2020-05-13,pais_vasco,País Vasco,John Hopkins University,13219,1454,0,577,5,12,0,2,-277,270,39,-3491,15256,6994,0.00037838655970934276,0.00832177531206657,,0.003478260869565153,,0.018016815694648303,0.005607476635514086,13214,1442,0,575,-3214,14986,6955
2020-05-13,la_rioja,La Rioja,John Hopkins University,4014,348,0,91,5,0,0,0,-58,63,3,799,2867,1484,0.00124719381391869,0.0,,0.0,-0.0676779463243874,0.022467902995720435,0.002025658338960179,4009,348,0,91,857,2804,1481
2020-05-13,extremadura,Extremadura,John Hopkins University,2923,492,0,109,4,3,0,0,-25,26,7,-51,2482,1761,0.0013703323055840322,0.006134969325153339,,0.0,,0.010586319218240936,0.003990877993158559,2919,489,0,109,-26,2456,1754
2020-05-13,cantabria,Cantabria,John Hopkins University,2256,205,0,79,0,0,0,0,-56,56,1,-59,2110,1030,0.0,0.0,,0.0,,0.027263875365141077,0.0009718172983479434,2256,205,0,79,-3,2054,1029
2020-05-14,castilla-la_mancha,Castilla-La Mancha,John Hopkins University,16513,2870,0,635,43,18,0,1,-25.0,50.0,21,7349,6294,9001,0.002610807528840242,0.006311360448807868,,0.001577287066246047,-0.0033902902088418507,0.008007687379884665,0.002338530066815059,16470,2852,0,634,7374,6244,8980
2020-05-14,navarra,Navarra,John Hopkins University,5116,500,0,136,11,2,0,1,-141.0,150.0,0,1066,3550,2045,0.002154750244858006,0.004016064257028162,,0.007407407407407307,-0.11681855840927924,0.044117647058823595,0.0,5105,498,0,135,1207,3400,2045
2020-05-14,melilla,Melilla,John Hopkins University,119,2,0,3,0,0,0,0,,,0,-2,119,44,0.0,0.0,,0.0,,,0.0,119,2,0,3,-2,119,44
2020-05-14,canarias,Canarias,John Hopkins University,2280,151,0,178,5,0,0,0,-5.0,10.0,1,623,1506,938,0.00219780219780219,0.0,,0.0,-0.0079617834394905,0.006684491978609541,0.0010672358591248265,2275,151,0,178,628,1496,937
2020-05-14,baleares,Baleares,John Hopkins University,1965,216,0,169,9,0,0,-2,-12.0,21.0,3,236,1513,1134,0.004601226993865115,0.0,,-0.011695906432748537,-0.048387096774193505,0.014075067024128751,0.0026525198938991412,1956,216,0,171,248,1492,1131
2020-05-14,murcia,Murcia,John Hopkins University,1534,143,0,112,2,1,0,0,-35.0,36.0,3,-643,2034,675,0.0013054830287206887,0.007042253521126751,,0.0,,0.018018018018018056,0.0044642857142858094,1532,142,0,112,-608,1998,672
2020-05-14,cataluna,Cataluña,John Hopkins University,55562,5882,0,2955,249,59,0,1,135.0,55.0,34,23776,25904,29339,0.004501654222334617,0.010132234243517058,,0.0003385240352065111,0.005710418341017709,0.0021277418855660812,0.0011602115679918423,55313,5823,0,2954,23641,25849,29305
2020-05-14,c_valenciana,C. Valenciana,John Hopkins University,10813,1358,0,721,29,9,0,4,-198.0,218.0,26,-253,9708,5415,0.00268916913946593,0.006671608598962209,,0.00557880055788007,,0.022971548998946156,0.004824642790870248,10784,1349,0,717,-55,9490,5389
2020-05-14,asturias,Asturias,John Hopkins University,2364,298,0,121,7,5,0,0,-5.0,7.0,3,1013,1053,1087,0.002969876962240159,0.017064846416382284,,0.0,-0.004911591355599265,0.006692160611854625,0.002767527675276771,2357,293,0,121,1018,1046,1084
2020-05-14,galicia,Galicia,John Hopkins University,9036,603,0,332,6,0,0,5,-120.0,126.0,6,150,8283,2921,0.0006644518272425071,0.0,,0.015290519877675823,-0.4444444444444444,0.015446855461566766,0.002058319039451195,9030,603,0,327,270,8157,2915
2020-05-14,madrid,Madrid,John Hopkins University,66469,8809,0,3574,207,30,0,10,-7.0,184.0,95,17277,40383,42057,0.003123962452084239,0.0034172456999659317,,0.0028058361391694042,-0.00040499884286049337,0.004577228289260882,0.0022639531004242652,66262,8779,0,3564,17284,40199,41962
2020-05-14,andalucia,Andalucía,John Hopkins University,12401,1344,0,754,42,8,0,3,-196.0,230.0,18,909,10148,6146,0.00339833319847882,0.0059880239520957446,,0.003994673768308976,-0.17737556561085976,0.02319015930631174,0.002937336814621494,12359,1336,0,751,1105,9918,6128
2020-05-14,castilla_y_leon,Castilla y León,John Hopkins University,18272,1930,0,548,99,5,0,0,43.0,51.0,35,8670,7672,8595,0.0054476421064215685,0.0025974025974024872,,0.0,0.004984351454735192,0.006692035165988708,0.004088785046729049,18173,1925,0,548,8627,7621,8560
2020-05-14,ceuta,Ceuta,John Hopkins University,116,4,0,4,0,0,0,0,-1.0,1.0,0,-48,160,11,0.0,0.0,,0.0,,0.0062893081761006275,0.0,116,4,0,4,-47,159,11
2020-05-14,aragon,Aragón,John Hopkins University,5432,837,0,266,43,1,0,1,-21.0,63.0,12,1061,3534,2637,0.007979216923362342,0.0011961722488038617,,0.0037735849056603765,-0.019408502772643277,0.01815038893690568,0.004571428571428671,5389,836,0,265,1082,3471,2625
2020-05-14,pais_vasco,País Vasco,John Hopkins University,13257,1454,0,578,38,0,0,1,38.0,,15,-3453,15256,7009,0.002874650124820244,0.0,,0.0017331022530329143,,,0.002144695453245582,13219,1454,0,577,-3491,15256,6994
2020-05-14,la_rioja,La Rioja,John Hopkins University,4016,348,0,91,2,0,0,0,-58.0,60.0,4,741,2927,1488,0.0004982561036372957,0.0,,0.0,-0.07259073842302877,0.020927799093128696,0.0026954177897573484,4014,348,0,91,799,2867,1484
2020-05-14,extremadura,Extremadura,John Hopkins University,2933,494,0,109,10,2,0,0,-97.0,105.0,11,-148,2587,1772,0.003421142661649057,0.004065040650406582,,0.0,,0.0423045930701047,0.006246450880181609,2923,492,0,109,-51,2482,1761
2020-05-14,cantabria,Cantabria,John Hopkins University,2263,206,0,79,7,1,0,0,-36.0,42.0,1,-95,2152,1031,0.00310283687943258,0.004878048780487809,,0.0,,0.019905213270142275,0.000970873786407811,2256,205,0,79,-59,2110,1030
2020-05-15,castilla-la_mancha,Castilla-La Mancha,John Hopkins University,16587,2883,0,636,74,13,0,1,27,34,26,7376,6328,9027,0.004481317749651881,0.0045296167247386165,,0.0015748031496063408,0.0036739692475167285,0.005401970130282763,0.0028885679368959583,16513,2870,0,635,7349,6294,9001
2020-05-15,navarra,Navarra,John Hopkins University,5137,501,0,136,21,1,0,0,-88,108,0,978,3658,2045,0.004104769351055415,0.0020000000000000018,,0.0,-0.0825515947467167,0.0304225352112677,0.0,5116,500,0,136,1066,3550,2045
2020-05-15,melilla,Melilla,John Hopkins University,119,2,0,3,0,0,0,0,-3,3,0,-5,122,44,0.0,0.0,,0.0,,0.025210084033613356,0.0,119,2,0,3,-2,119,44
2020-05-15,canarias,Canarias,John Hopkins University,2284,151,0,178,4,0,0,0,-14,18,1,609,1524,939,0.0017543859649122862,0.0,,0.0,-0.022471910112359605,0.01195219123505975,0.0010660980810235365,2280,151,0,178,623,1506,938
2020-05-15,baleares,Baleares,John Hopkins University,1982,216,0,169,17,0,0,0,11,6,0,247,1519,1134,0.00865139949109417,0.0,,0.0,0.04661016949152552,0.00396563119629878,0.0,1965,216,0,169,236,1513,1134
2020-05-15,murcia,Murcia,John Hopkins University,1542,144,0,112,8,1,0,0,-32,39,1,-675,2073,676,0.0052151238591917615,0.006993006993007089,,0.0,,0.019174041297935096,0.001481481481481417,1534,143,0,112,-643,2034,675
2020-05-15,cataluna,Cataluña,John Hopkins University,55685,5915,0,2956,123,33,0,1,-73,163,0,23703,26067,29339,0.0022137432057880435,0.005610336620197165,,0.00033840947546526223,-0.00307032301480481,0.0062924644842494715,0.0,55562,5882,0,2955,23776,25904,29339
2020-05-15,c_valenciana,C. Valenciana,John Hopkins University,10850,1365,0,722,37,7,0,1,-23,53,20,-276,9761,5435,0.0034218070840654757,0.005154639175257714,,0.001386962552011095,,0.005459414915533589,0.003693444136657398,10813,1358,0,721,-253,9708,5415
2020-05-15,asturias,Asturias,John Hopkins University,2366,299,0,121,2,1,0,0,-1,2,0,1012,1055,1087,0.0008460236886633776,0.003355704697986628,,0.0,-0.000987166831194486,0.0018993352326686086,0.0,2364,298,0,121,1013,1053,1087
2020-05-15,galicia,Galicia,John Hopkins University,9041,604,0,332,5,1,0,0,-533,537,2,-383,8820,2923,0.0005533421868082478,0.0016583747927032544,,0.0,-3.5533333333333332,0.06483158275986955,0.000684697021567926,9036,603,0,332,150,8283,2921
2020-05-15,madrid,Madrid,John Hopkins University,66573,8826,0,3577,104,17,0,3,-116,203,100,17161,40586,42157,0.0015646391550947492,0.0019298444772390955,,0.0008393956351426812,-0.006714128610291192,0.005026867741376284,0.0023777254678174486,66469,8809,0,3574,17277,40383,42057
2020-05-15,andalucia,Andalucía,John Hopkins University,12420,1355,0,758,19,11,0,4,-163,171,15,746,10319,6161,0.0015321345052818902,0.008184523809523725,,0.0053050397877985045,-0.17931793179317934,0.01685061095782414,0.0024406117800195304,12401,1344,0,754,909,10148,6146
2020-05-15,castilla_y_leon,Castilla y León,John Hopkins University,18369,1940,0,549,97,10,0,1,24,63,54,8694,7735,8649,0.00530866900175142,0.005181347150259086,,0.0018248175182482562,0.0027681660899654403,0.008211678832116709,0.006282722513089034,18272,1930,0,548,8670,7672,8595
2020-05-15,ceuta,Ceuta,John Hopkins University,116,4,0,4,0,0,0,0,-3,3,0,-51,163,11,0.0,0.0,,0.0,,0.018750000000000044,0.0,116,4,0,4,-48,160,11
2020-05-15,aragon,Aragón,John Hopkins University,5456,838,0,266,24,1,0,0,-98,121,11,963,3655,2648,0.004418262150220897,0.0011947431302270495,,0.0,-0.09236569274269557,0.034238822863610574,0.004171406901782415,5432,837,0,266,1061,3534,2637
2020-05-15,pais_vasco,País Vasco,John Hopkins University,13291,1455,0,578,34,1,0,0,-389,422,2,-3842,15678,7011,0.002564682809081953,0.0006877579092159358,,0.0,,0.027661248033560515,0.00028534741047225864,13257,1454,0,578,-3453,15256,7009
2020-05-15,la_rioja,La Rioja,John Hopkins University,4020,348,0,91,4,0,0,0,-59,63,2,682,2990,1490,0.0009960159362549792,0.0,,0.0,-0.07962213225371118,0.021523744448240567,0.0013440860215054862,4016,348,0,91,741,2927,1488
2020-05-15,extremadura,Extremadura,John Hopkins University,2944,497,0,109,11,3,0,0,-14,22,0,-162,2609,1772,0.0037504261847938203,0.006072874493927127,,0.0,,0.008504058755315125,0.0,2933,494,0,109,-148,2587,1772
2020-05-15,cantabria,Cantabria,John Hopkins University,2265,206,0,79,2,0,0,0,-41,43,1,-136,2195,1032,0.0008837825894829621,0.0,,0.0,,0.019981412639405116,0.0009699321047527132,2263,206,0,79,-95,2152,1031
2020-05-16,castilla-la_mancha,Castilla-La Mancha,John Hopkins University,16618,2893,0,637,31,10,0,1,-29.0,50.0,27,7347,6378,9054,0.0018689335021402353,0.003468609087755814,,0.0015723270440251014,-0.003931670281995703,0.00790139064475337,0.0029910269192423566,16587,2883,0,636,7376,6328,9027
2020-05-16,navarra,Navarra,John Hopkins University,5148,503,0,136,11,2,0,0,-84.0,93.0,0,894,3751,2045,0.0021413276231263545,0.003992015968063978,,0.0,-0.08588957055214719,0.025423728813559254,0.0,5137,501,0,136,978,3658,2045
2020-05-16,melilla,Melilla,John Hopkins University,121,2,0,3,2,0,0,0,,2.0,0,-5,124,44,0.01680672268907557,0.0,,0.0,,0.016393442622950838,0.0,119,2,0,3,-5,122,44
2020-05-16,canarias,Canarias,John Hopkins University,2289,151,0,178,5,0,0,0,5.0,,0,614,1524,939,0.002189141856392185,0.0,,0.0,0.008210180623973828,,0.0,2284,151,0,178,609,1524,939
2020-05-16,baleares,Baleares,John Hopkins University,1991,218,0,169,9,2,0,0,3.0,4.0,2,250,1523,1136,0.004540867810292726,0.0092592592592593,,0.0,0.012145748987854255,0.0026333113890717463,0.0017636684303350414,1982,216,0,169,247,1519,1134
2020-05-16,murcia,Murcia,John Hopkins University,1551,144,0,112,9,0,0,0,-2.0,11.0,0,-677,2084,676,0.005836575875486361,0.0,,0.0,,0.005306319343945987,0.0,1542,144,0,112,-675,2073,676
2020-05-16,cataluna,Cataluña,John Hopkins University,55824,5944,0,2957,139,29,0,1,5.0,105.0,61,23708,26172,29400,0.0024961838915327217,0.004902789518174133,,0.0003382949932340118,0.00021094376239294554,0.004028081482333912,0.0020791438017655484,55685,5915,0,2956,23703,26067,29339
2020-05-16,c_valenciana,C. Valenciana,John Hopkins University,10893,1366,0,723,43,1,0,1,-104.0,146.0,19,-380,9907,5454,0.003963133640553007,0.00073260073260073,,0.0013850415512466352,,0.014957483864358245,0.003495860165593445,10850,1365,0,722,-276,9761,5435
2020-05-16,asturias,Asturias,John Hopkins University,2366,299,0,121,0,0,0,0,-6.0,6.0,0,1006,1061,1087,0.0,0.0,,0.0,-0.005928853754940677,0.005687203791469253,0.0,2366,299,0,121,1012,1055,1087
2020-05-16,galicia,Galicia,John Hopkins University,9051,606,0,332,10,2,0,0,-327.0,335.0,3,-710,9155,2926,0.0011060723371307812,0.0033112582781456013,,0.0,,0.03798185941043086,0.0010263427984946727,9041,604,0,332,-383,8820,2923
2020-05-16,madrid,Madrid,John Hopkins University,66597,8847,0,3584,24,21,0,7,-109.0,112.0,70,17052,40698,42227,0.0003605065116487616,0.0023793337865398723,,0.001956947162426559,-0.006351611211467878,0.0027595722662987487,0.001660459710131068,66573,8826,0,3577,17161,40586,42157
2020-05-16,andalucia,Andalucía,John Hopkins University,12450,1358,0,760,30,3,0,2,-265.0,292.0,13,481,10611,6174,0.0024154589371980784,0.0022140221402213722,,0.0026385224274405594,-0.3552278820375335,0.028297315631359732,0.0021100470702808405,12420,1355,0,758,746,10319,6161
2020-05-16,castilla_y_leon,Castilla y León,John Hopkins University,18470,1946,0,550,101,6,0,1,-886.0,981.0,41,7808,8716,8690,0.005498394033425891,0.003092783505154628,,0.0018214936247722413,-0.10190936277892804,0.12682611506140917,0.004740432419932938,18369,1940,0,549,8694,7735,8649
2020-05-16,ceuta,Ceuta,John Hopkins University,116,4,0,4,0,0,0,0,,,0,-51,163,11,0.0,0.0,,0.0,,,0.0,116,4,0,4,-51,163,11
2020-05-16,aragon,Aragón,John Hopkins University,5478,838,0,266,22,0,0,0,-50.0,72.0,7,913,3727,2655,0.0040322580645162365,0.0,,0.0,-0.05192107995846318,0.01969904240766085,0.0026435045317221295,5456,838,0,266,963,3655,2648
2020-05-16,pais_vasco,País Vasco,John Hopkins University,13407,1459,0,578,116,4,0,0,-238.0,350.0,4,-4080,16028,7015,0.008727710480776363,0.0027491408934707806,,0.0,,0.022324276055619263,0.0005705320211097931,13291,1455,0,578,-3842,15678,7011
2020-05-16,la_rioja,La Rioja,John Hopkins University,4024,349,0,91,4,1,0,0,-55.0,58.0,6,627,3048,1496,0.0009950248756218638,0.002873563218390718,,0.0,-0.08064516129032262,0.019397993311036865,0.00402684563758382,4020,348,0,91,682,2990,1490
2020-05-16,extremadura,Extremadura,John Hopkins University,2947,500,0,110,3,3,0,1,-27.0,27.0,3,-189,2636,1775,0.0010190217391303769,0.006036217303822866,,0.00917431192660545,,0.010348792640858528,0.0016930022573362624,2944,497,0,109,-162,2609,1772
2020-05-16,cantabria,Cantabria,John Hopkins University,2268,207,0,79,3,1,0,0,-76.0,78.0,1,-212,2273,1033,0.0013245033112583293,0.004854368932038833,,0.0,,0.035535307517084336,0.0009689922480620172,2265,206,0,79,-136,2195,1032
2020-05-17,castilla-la_mancha,Castilla-La Mancha,John Hopkins University,16648,2898,0,637,30,5,0,0,11.0,14.0,12,7358,6392,9066,0.0018052713924658903,0.001728309713100673,,0.0,0.0014972097454744038,0.002195045468798895,0.001325381047051044,16618,2893,0,637,7347,6378,9054
2020-05-17,navarra,Navarra,John Hopkins University,5178,503,0,136,30,0,0,0,-124.0,154.0,0,770,3905,2045,0.005827505827505908,0.0,,0.0,-0.13870246085011184,0.04105571847507328,0.0,5148,503,0,136,894,3751,2045
2020-05-17,melilla,Melilla,John Hopkins University,121,2,0,3,0,0,0,0,-1.0,1.0,0,-6,125,44,0.0,0.0,,0.0,,0.008064516129032251,0.0,121,2,0,3,-5,124,44
2020-05-17,canarias,Canarias,John Hopkins University,2294,153,0,178,5,2,0,0,-10.0,13.0,3,604,1537,942,0.002184359982525086,0.013245033112582849,,0.0,-0.016286644951140072,0.00853018372703418,0.0031948881789136685,2289,151,0,178,614,1524,939
2020-05-17,baleares,Baleares,John Hopkins University,1993,218,0,169,2,0,0,0,-8.0,10.0,0,242,1533,1136,0.0010045203415369741,0.0,,0.0,-0.03200000000000003,0.006565988181221227,0.0,1991,218,0,169,250,1523,1136
2020-05-17,murcia,Murcia,John Hopkins University,1556,145,0,112,5,1,0,0,-92.0,96.0,2,-769,2180,678,0.003223726627981982,0.00694444444444442,,0.0,,0.04606525911708248,0.002958579881656709,1551,144,0,112,-677,2084,676
2020-05-17,cataluna,Cataluña,John Hopkins University,55921,5956,0,2957,97,12,0,0,54.0,31.0,21,23762,26203,29421,0.0017376038979650676,0.0020188425302827273,,0.0,0.002277712164670209,0.0011844719547609017,0.0007142857142856673,55824,5944,0,2957,23708,26172,29400
2020-05-17,c_valenciana,C. Valenciana,John Hopkins University,10914,1370,0,725,21,4,0,2,-46.0,63.0,15,-426,9970,5469,0.0019278435692646756,0.002928257686676483,,0.0027662517289073207,,0.00635914000201887,0.002750275027502802,10893,1366,0,723,-380,9907,5454
2020-05-17,asturias,Asturias,John Hopkins University,2370,301,0,121,4,2,0,0,,2.0,1,1006,1063,1088,0.0016906170752324368,0.006688963210702337,,0.0,,0.0018850141376061114,0.0009199632014720294,2366,299,0,121,1006,1061,1087
2020-05-17,galicia,Galicia,John Hopkins University,9056,607,0,332,5,1,0,0,-45.0,49.0,8,-755,9204,2934,0.0005524251463926433,0.0016501650165017256,,0.0,,0.005352266521026827,0.002734107997265811,9051,606,0,332,-710,9155,2926
2020-05-17,madrid,Madrid,John Hopkins University,66625,8863,0,3594,28,16,0,10,-26.0,38.0,56,17026,40736,42283,0.00042043935913027575,0.0018085226630495388,,0.002790178571428603,-0.0015247478301665396,0.0009337068160597539,0.0013261657233523128,66597,8847,0,3584,17052,40698,42227
2020-05-17,andalucia,Andalucía,John Hopkins University,12458,1358,0,761,8,0,0,1,-52.0,60.0,4,429,10671,6178,0.000642570281124577,0.0,,0.001315789473684159,-0.10810810810810811,0.005654509471303415,0.0006478781988985549,12450,1358,0,760,481,10611,6174
2020-05-17,castilla_y_leon,Castilla y León,John Hopkins University,18512,1953,0,551,42,7,0,1,35.0,,27,7843,8716,8717,0.0022739577693557944,0.003597122302158251,,0.0018181818181817189,0.004482581967213184,,0.0031070195627158625,18470,1946,0,550,7808,8716,8690
2020-05-17,ceuta,Ceuta,John Hopkins University,116,4,0,4,0,0,0,0,,,0,-51,163,11,0.0,0.0,,0.0,,,0.0,116,4,0,4,-51,163,11
2020-05-17,aragon,Aragón,John Hopkins University,5503,838,0,267,25,0,0,1,-20.0,45.0,4,893,3772,2659,0.004563709382986447,0.0,,0.003759398496240518,-0.02190580503833517,0.012074054199087803,0.0015065913370997386,5478,838,0,266,913,3727,2655
2020-05-17,pais_vasco,País Vasco,John Hopkins University,13422,1466,0,578,15,7,0,0,-124.0,132.0,1,-4204,16160,7016,0.001118818527634735,0.00479780671692942,,0.0,,0.00823558772148747,0.00014255167498222754,13407,1459,0,578,-4080,16028,7015
2020-05-17,la_rioja,La Rioja,John Hopkins University,4024,351,0,91,0,2,0,0,-61.0,59.0,0,566,3107,1496,0.0,0.005730659025787954,,0.0,-0.09728867623604465,0.019356955380577467,0.0,4024,349,0,91,627,3048,1496
2020-05-17,extremadura,Extremadura,John Hopkins University,2948,500,0,110,1,0,0,0,-15.0,16.0,0,-204,2652,1775,0.000339328130301908,0.0,,0.0,,0.006069802731411222,0.0,2947,500,0,110,-189,2636,1775
2020-05-17,cantabria,Cantabria,John Hopkins University,2271,207,0,79,3,0,0,0,-11.0,14.0,2,-223,2287,1035,0.001322751322751392,0.0,,0.0,,0.006159260888693341,0.0019361084220717029,2268,207,0,79,-212,2273,1033
2020-05-18,castilla-la_mancha,Castilla-La Mancha,John Hopkins University,16677,2900,0,638,29,2,0,1,13,14.0,16,7385,6392,9082,0.0017419509851033244,0.0006901311249136732,,0.0015698587127157548,0.0017634291915356037,0.002195045468798895,0.0017648356496802187,16648,2898,0,637,7372,6378,9066
2020-05-18,navarra,Navarra,John Hopkins University,5183,503,0,136,5,0,0,0,-149,154.0,0,775,3905,2045,0.0009656237929702716,0.0,,0.0,-0.1612554112554112,0.04105571847507328,0.0,5178,503,0,136,924,3751,2045
2020-05-18,melilla,Melilla,John Hopkins University,121,2,0,3,0,0,0,0,-1,1.0,0,-6,125,44,0.0,0.0,,0.0,,0.008064516129032251,0.0,121,2,0,3,-5,124,44
2020-05-18,canarias,Canarias,John Hopkins University,2294,155,0,178,0,2,0,0,-15,13.0,0,602,1537,942,0.0,0.013071895424836555,,0.0,-0.024311183144246407,0.00853018372703418,0.0,2294,153,0,178,617,1524,942
2020-05-18,baleares,Baleares,John Hopkins University,2003,219,0,168,10,1,0,-1,-1,10.0,1,251,1533,1137,0.005017561465127995,0.004587155963302836,,-0.00591715976331364,-0.003968253968253954,0.006565988181221227,0.0008802816901407606,1993,218,0,169,252,1523,1136
2020-05-18,murcia,Murcia,John Hopkins University,1558,145,0,112,2,0,0,0,-94,96.0,1,-767,2180,679,0.0012853470437017567,0.0,,0.0,,0.04606525911708248,0.001474926253687281,1556,145,0,112,-673,2084,678
2020-05-18,cataluna,Cataluña,John Hopkins University,55921,5981,0,2960,0,25,0,3,-56,31.0,38,23737,26203,29459,0.0,0.004197447951645339,,0.00101454176530269,-0.0023536334215945587,0.0011844719547609017,0.001291594439346122,55921,5956,0,2957,23793,26172,29421
2020-05-18,c_valenciana,C. Valenciana,John Hopkins University,10927,1376,0,727,13,6,0,2,-56,63.0,269,-419,9970,5738,0.001191130657870687,0.004379562043795637,,0.0027586206896552667,,0.00635914000201887,0.049186322910952596,10914,1370,0,725,-363,9907,5469
2020-05-18,asturias,Asturias,John Hopkins University,2373,303,0,121,3,2,0,0,-1,2.0,0,1007,1063,1088,0.0012658227848101333,0.006644518272425293,,0.0,-0.0009920634920634885,0.0018850141376061114,0.0,2370,301,0,121,1008,1061,1088
2020-05-18,galicia,Galicia,John Hopkins University,9058,607,0,332,2,0,0,0,-47,49.0,1,-753,9204,2935,0.00022084805653710404,0.0,,0.0,,0.005352266521026827,0.0003408316291750868,9056,607,0,332,-706,9155,2934
2020-05-18,madrid,Madrid,John Hopkins University,66828,8894,0,3600,203,31,0,6,134,38.0,67,17198,40736,42350,0.003046904315197052,0.0034976870134266758,,0.0016694490818029983,0.007852789498359103,0.0009337068160597539,0.0015845611711562402,66625,8863,0,3594,17064,40698,42283
2020-05-18,andalucia,Andalucía,John Hopkins University,12489,1367,0,760,31,9,0,-1,-38,60.0,4,451,10671,6182,0.002488360892599184,0.006627393225331346,,-0.0013140604467805073,-0.07770961145194277,0.005654509471303415,0.0006474587245062224,12458,1358,0,761,489,10611,6178
2020-05-18,castilla_y_leon,Castilla y León,John Hopkins University,18549,1960,0,551,37,7,0,0,30,,12,7873,8716,8729,0.0019987035436472844,0.0035842293906809264,,0.0,0.003825066938671462,,0.001376620396925654,18512,1953,0,551,7843,8716,8717
2020-05-18,ceuta,Ceuta,John Hopkins University,117,4,0,4,1,0,0,0,1,,0,-50,163,11,0.008620689655172376,0.0,,0.0,,,0.0,116,4,0,4,-51,163,11
2020-05-18,aragon,Aragón,John Hopkins University,5520,843,0,255,17,5,0,-12,-33,45.0,8,905,3772,2667,0.003089224059603879,0.005966587112171906,,-0.0449438202247191,-0.03518123667377404,0.012074054199087803,0.00300864986837146,5503,838,0,267,938,3727,2659
2020-05-18,pais_vasco,País Vasco,John Hopkins University,13422,1470,0,578,0,4,0,0,-136,132.0,5,-4208,16160,7021,0.0,0.0027285129604366354,,0.0,,0.00823558772148747,0.0007126567844926157,13422,1466,0,578,-4072,16028,7016
2020-05-18,la_rioja,La Rioja,John Hopkins University,4027,352,0,91,3,1,0,0,-57,59.0,2,568,3107,1498,0.0007455268389662262,0.002849002849002913,,0.0,-0.09119999999999995,0.019356955380577467,0.0013368983957218195,4024,351,0,91,625,3048,1496
2020-05-18,extremadura,Extremadura,John Hopkins University,3038,504,0,110,90,4,0,0,70,16.0,4,-118,2652,1779,0.030529172320217013,0.008000000000000007,,0.0,,0.006069802731411222,0.0022535211267604716,2948,500,0,110,-188,2636,1775
2020-05-18,cantabria,Cantabria,John Hopkins University,2273,208,0,79,2,1,0,0,-13,14.0,0,-222,2287,1035,0.0008806693086746975,0.004830917874396157,,0.0,,0.006159260888693341,0.0,2271,207,0,79,-209,2273,1035
2020-05-19,castilla-la_mancha,Castilla-La Mancha,John Hopkins University,16739,2913,0,639,62,13,0,1,35,14.0,40,7434,6392,9122,0.0037176950290820354,0.0044827586206896974,,0.0015673981191222097,0.004730368968779652,0.002195045468798895,0.004404316229905225,16677,2900,0,638,7399,6378,9082
2020-05-19,navarra,Navarra,John Hopkins University,5192,503,0,136,9,0,0,0,-145,154.0,3,784,3905,2048,0.0017364460737023801,0.0,,0.0,-0.15608180839612484,0.04105571847507328,0.0014669926650365817,5183,503,0,136,929,3751,2045
2020-05-19,melilla,Melilla,John Hopkins University,121,2,0,3,0,0,0,0,-1,1.0,0,-6,125,44,0.0,0.0,,0.0,,0.008064516129032251,0.0,121,2,0,3,-5,124,44
2020-05-19,canarias,Canarias,John Hopkins University,2300,155,0,179,6,0,0,1,-7,13.0,1,608,1537,943,0.0026155187445509043,0.0,,0.00561797752808979,-0.011382113821138184,0.00853018372703418,0.0010615711252655036,2294,155,0,178,615,1524,942
2020-05-19,baleares,Baleares,John Hopkins University,2016,221,0,168,13,2,0,0,1,10.0,5,262,1533,1142,0.006490264603095319,0.009132420091324311,,0.0,0.003831417624521105,0.006565988181221227,0.004397537379067673,2003,219,0,168,261,1523,1137
2020-05-19,murcia,Murcia,John Hopkins University,1560,148,0,112,2,3,0,0,-97,96.0,0,-768,2180,679,0.0012836970474967568,0.020689655172413834,,0.0,,0.04606525911708248,0.0,1558,145,0,112,-671,2084,679
2020-05-19,cataluna,Cataluña,John Hopkins University,55888,6021,0,2969,63,40,0,9,-8,31.0,38,23664,26203,29497,0.0011285266457681242,0.0066878448419995795,,0.0030405405405404817,-0.00033795201081443516,0.0011844719547609017,0.0012899283750296142,55825,5981,0,2960,23672,26172,29459
2020-05-19,c_valenciana,C. Valenciana,John Hopkins University,10949,1378,0,727,22,2,0,0,-43,63.0,4,-399,9970,5742,0.0020133613983710497,0.0014534883720929148,,0.0,,0.00635914000201887,0.0006971070059254014,10927,1376,0,727,-356,9907,5738
2020-05-19,asturias,Asturias,John Hopkins University,2374,304,0,121,1,1,0,0,-2,2.0,1,1007,1063,1089,0.0004214075010535723,0.0033003300330032292,,0.0,-0.001982160555004997,0.0018850141376061114,0.0009191176470588758,2373,303,0,121,1009,1061,1088
2020-05-19,galicia,Galicia,John Hopkins University,9067,607,0,334,9,0,0,2,-40,49.0,4,-744,9204,2939,0.0009935968204901613,0.0,,0.006024096385542244,,0.005352266521026827,0.0013628620102215105,9058,607,0,332,-704,9155,2935
2020-05-19,madrid,Madrid,John Hopkins University,66967,8912,0,3610,139,18,0,10,83,38.0,72,17319,40736,42422,0.002079966481115747,0.002023836294130943,,0.002777777777777768,0.004815502436760211,0.0009337068160597539,0.0017001180637543634,66828,8894,0,3600,17236,40698,42350
2020-05-19,andalucia,Andalucía,John Hopkins University,12502,1371,0,764,13,4,0,4,-51,60.0,14,460,10671,6196,0.0010409160060853573,0.002926115581565414,,0.0052631578947368585,-0.09980430528375739,0.005654509471303415,0.0022646392753153943,12489,1367,0,760,511,10611,6182
2020-05-19,castilla_y_leon,Castilla y León,John Hopkins University,18586,1960,0,555,37,0,0,4,37,,5,7910,8716,8734,0.0019947166963178997,0.0,,0.007259528130671544,0.0046996062492061785,,0.0005728032993470578,18549,1960,0,551,7873,8716,8729
2020-05-19,ceuta,Ceuta,John Hopkins University,119,4,0,4,2,0,0,0,2,,0,-48,163,11,0.017094017094017033,0.0,,0.0,,,0.0,117,4,0,4,-50,163,11
2020-05-19,aragon,Aragón,John Hopkins University,5551,847,0,255,31,4,0,0,-18,45.0,-233,932,3772,2434,0.00561594202898541,0.004744958481613271,,0.0,-0.0189473684210526,0.012074054199087803,-0.08736407949006375,5520,843,0,255,950,3727,2667
2020-05-19,pais_vasco,País Vasco,John Hopkins University,13412,1480,0,578,26,10,0,0,-116,132.0,3,-4228,16160,7024,0.0019423278051695636,0.006802721088435382,,0.0,,0.00823558772148747,0.00042728955989179696,13386,1470,0,578,-4112,16028,7021
2020-05-19,la_rioja,La Rioja,John Hopkins University,4033,353,0,91,6,1,0,0,-54,59.0,1,573,3107,1499,0.0014899428855226216,0.0028409090909091717,,0.0,-0.0861244019138756,0.019356955380577467,0.0006675567423231055,4027,352,0,91,627,3048,1498
2020-05-19,extremadura,Extremadura,John Hopkins University,3040,504,0,110,2,0,0,0,-14,16.0,1,-116,2652,1780,0.0006583278472680476,0.0,,0.0,,0.006069802731411222,0.0005621135469364713,3038,504,0,110,-102,2636,1779
2020-05-19,cantabria,Cantabria,John Hopkins University,2277,209,0,79,4,1,0,0,-11,14.0,1,-219,2287,1036,0.001759788825340891,0.004807692307692291,,0.0,,0.006159260888693341,0.0009661835748793202,2273,208,0,79,-208,2273,1035
2020-05-20,castilla-la_mancha,Castilla-La Mancha,John Hopkins University,16789,2919,0,639,50,6,0,0,30.0,14.0,16,7478,6392,9138,0.002987036262620313,0.002059732234809486,,0.0,0.004027926960257888,0.002195045468798895,0.0017540013155010747,16739,2913,0,639,7448,6378,9122
2020-05-20,navarra,Navarra,John Hopkins University,5195,506,0,136,3,3,0,0,-154.0,154.0,0,784,3905,2048,0.0005778120184900537,0.005964214711729587,,0.0,-0.16417910447761197,0.04105571847507328,0.0,5192,503,0,136,938,3751,2048
2020-05-20,melilla,Melilla,John Hopkins University,121,2,0,3,0,0,0,0,-1.0,1.0,0,-6,125,44,0.0,0.0,,0.0,,0.008064516129032251,0.0,121,2,0,3,-5,124,44
2020-05-20,canarias,Canarias,John Hopkins University,2307,155,0,179,7,0,0,0,-6.0,13.0,1,615,1537,944,0.003043478260869481,0.0,,0.0,-0.009661835748792313,0.00853018372703418,0.0010604453870626251,2300,155,0,179,621,1524,943
2020-05-20,baleares,Baleares,John Hopkins University,2024,221,0,169,8,0,0,1,-2.0,10.0,2,270,1533,1144,0.003968253968253954,0.0,,0.005952380952380931,-0.007352941176470562,0.006565988181221227,0.0017513134851139256,2016,221,0,168,272,1523,1142
2020-05-20,murcia,Murcia,John Hopkins University,1570,149,0,112,10,1,0,0,-87.0,96.0,1,-759,2180,680,0.0064102564102563875,0.006756756756756799,,0.0,,0.04606525911708248,0.0014727540500736325,1560,148,0,112,-672,2084,679
2020-05-20,cataluna,Cataluña,John Hopkins University,55888,6021,0,2969,0,0,0,0,-31.0,31.0,0,23664,26203,29497,0.0,0.0,,0.0,-0.0013082928887950818,0.0011844719547609017,0.0,55888,6021,0,2969,23695,26172,29497
2020-05-20,c_valenciana,C. Valenciana,John Hopkins University,10987,1383,0,730,38,5,0,3,-30.0,63.0,5,-366,9970,5747,0.0034706365878163226,0.0036284470246734646,,0.004126547455295837,,0.00635914000201887,0.0008707767328457461,10949,1378,0,727,-336,9907,5742
2020-05-20,asturias,Asturias,John Hopkins University,2374,307,0,121,0,3,0,0,-5.0,2.0,0,1004,1063,1089,0.0,0.009868421052631637,,0.0,-0.0049554013875123815,0.0018850141376061114,0.0,2374,304,0,121,1009,1061,1089
2020-05-20,galicia,Galicia,John Hopkins University,9077,608,0,334,10,1,0,0,-40.0,49.0,4,-735,9204,2943,0.0011029006286533694,0.0016474464579900872,,0.0,,0.005352266521026827,0.0013610071452874184,9067,607,0,334,-695,9155,2939
2020-05-20,madrid,Madrid,John Hopkins University,67049,8931,0,3617,82,19,0,7,25.0,38.0,75,17382,40736,42497,0.0012244837009274256,0.0021319569120288318,,0.0019390581717451116,0.001440341072766138,0.0009337068160597539,0.0017679505916741167,66967,8912,0,3610,17357,40698,42422
2020-05-20,andalucia,Andalucía,John Hopkins University,12547,1375,0,766,45,4,0,2,-19.0,60.0,14,501,10671,6210,0.003599424092145309,0.0029175784099197966,,0.002617801047120505,-0.03653846153846152,0.005654509471303415,0.002259522272433756,12502,1371,0,764,520,10611,6196
2020-05-20,castilla_y_leon,Castilla y León,John Hopkins University,18627,1960,0,561,41,0,0,6,41.0,,1,7951,8716,8735,0.0022059614763800806,0.0,,0.0108108108108107,0.005183312262958317,,0.00011449507671179582,18586,1960,0,555,7910,8716,8734
2020-05-20,ceuta,Ceuta,John Hopkins University,119,4,0,4,0,0,0,0,,,0,-48,163,11,0.0,0.0,,0.0,,,0.0,119,4,0,4,-48,163,11
2020-05-20,aragon,Aragón,John Hopkins University,5588,848,0,256,37,1,0,1,-9.0,45.0,8,968,3772,2442,0.006665465681859217,0.0011806375442739991,,0.0039215686274509665,-0.0092118730808598,0.012074054199087803,0.0032867707477404196,5551,847,0,255,977,3727,2434
2020-05-20,pais_vasco,País Vasco,John Hopkins University,13421,1483,0,578,9,3,0,0,-126.0,132.0,8,-4222,16160,7032,0.0006710408589323258,0.002027027027027062,,0.0,,0.00823558772148747,0.001138952164009055,13412,1480,0,578,-4096,16028,7024
2020-05-20,la_rioja,La Rioja,John Hopkins University,4033,354,0,91,0,1,0,0,-60.0,59.0,5,572,3107,1504,0.0,0.0028328611898016387,,0.0,-0.09493670886075944,0.019356955380577467,0.0033355570380253496,4033,353,0,91,632,3048,1499
2020-05-20,extremadura,Extremadura,John Hopkins University,3042,505,0,110,2,1,0,0,-15.0,16.0,0,-115,2652,1780,0.0006578947368420796,0.001984126984126977,,0.0,,0.006069802731411222,0.0,3040,504,0,110,-100,2636,1780
2020-05-20,cantabria,Cantabria,John Hopkins University,2279,209,0,79,2,0,0,0,-12.0,14.0,0,-217,2287,1036,0.0008783487044357052,0.0,,0.0,,0.006159260888693341,0.0,2277,209,0,79,-205,2273,1036
2020-05-21,castilla-la_mancha,Castilla-La Mancha,John Hopkins University,16830,2929,0,639,41,10,0,0,17.0,14.0,16,7509,6392,9138,0.002442075168265001,0.0034258307639603025,,0.0,0.002269087026161243,0.002195045468798895,0.0017540013155010747,16789,2919,0,639,7492,6378,9122
2020-05-21,navarra,Navarra,John Hopkins University,5200,508,0,136,5,2,0,0,-151.0,154.0,0,787,3905,2048,0.0009624639076035724,0.0039525691699604515,,0.0,-0.16098081023454158,0.04105571847507328,0.0,5195,506,0,136,938,3751,2048
2020-05-21,melilla,Melilla,John Hopkins University,121,2,0,3,0,0,0,0,-1.0,1.0,0,-6,125,44,0.0,0.0,,0.0,,0.008064516129032251,0.0,121,2,0,3,-5,124,44
2020-05-21,canarias,Canarias,John Hopkins University,2312,155,0,179,5,0,0,0,-8.0,13.0,1,620,1537,944,0.0021673168617251104,0.0,,0.0,-0.01273885350318471,0.00853018372703418,0.0010604453870626251,2307,155,0,179,628,1524,943
2020-05-21,baleares,Baleares,John Hopkins University,2037,222,0,169,13,1,0,1,2.0,10.0,2,282,1533,1144,0.006422924901185789,0.004524886877828038,,0.005952380952380931,0.0071428571428571175,0.006565988181221227,0.0017513134851139256,2024,221,0,168,280,1523,1142
2020-05-21,murcia,Murcia,John Hopkins University,1572,149,0,112,2,0,0,0,-94.0,96.0,1,-757,2180,680,0.001273885350318471,0.0,,0.0,,0.04606525911708248,0.0014727540500736325,1570,149,0,112,-663,2084,679
2020-05-21,cataluna,Cataluña,John Hopkins University,57036,6656,0,2969,1148,635,0,0,482.0,31.0,0,24177,26203,29497,0.020541082164328595,0.10546420860322203,,0.0,0.02034184427094332,0.0011844719547609017,0.0,55888,6021,0,2969,23695,26172,29497
2020-05-21,c_valenciana,C. Valenciana,John Hopkins University,11021,1389,0,730,34,6,0,3,-35.0,63.0,5,-338,9970,5747,0.0030945663056338724,0.00433839479392617,,0.004126547455295837,,0.00635914000201887,0.0008707767328457461,10987,1383,0,727,-303,9907,5742
2020-05-21,asturias,Asturias,John Hopkins University,2376,307,0,121,2,0,0,0,,2.0,0,1006,1063,1089,0.0008424599831506896,0.0,,0.0,,0.0018850141376061114,0.0,2374,307,0,121,1006,1061,1089
2020-05-21,galicia,Galicia,John Hopkins University,9084,609,0,334,7,1,0,0,-43.0,49.0,4,-729,9204,2943,0.0007711799052549928,0.00164473684210531,,0.0,,0.005352266521026827,0.0013610071452874184,9077,608,0,334,-686,9155,2939
2020-05-21,madrid,Madrid,John Hopkins University,67425,8944,0,3617,376,13,0,7,325.0,38.0,75,17745,40736,42497,0.0056078390430878144,0.0014556040756914523,,0.0019390581717451116,0.018656716417910557,0.0009337068160597539,0.0017679505916741167,67049,8931,0,3610,17420,40698,42422
2020-05-21,andalucia,Andalucía,John Hopkins University,12576,1377,0,766,29,2,0,2,-33.0,60.0,14,528,10671,6210,0.002311309476368928,0.001454545454545375,,0.002617801047120505,-0.05882352941176472,0.005654509471303415,0.002259522272433756,12547,1375,0,764,561,10611,6196
2020-05-21,castilla_y_leon,Castilla y León,John Hopkins University,18674,1961,0,561,47,1,0,6,46.0,,1,7997,8716,8735,0.002523218983196518,0.0005102040816327147,,0.0108108108108107,0.005785435794239735,,0.00011449507671179582,18627,1960,0,555,7951,8716,8734
2020-05-21,ceuta,Ceuta,John Hopkins University,124,4,0,4,5,0,0,0,5.0,,0,-43,163,11,0.04201680672268915,0.0,,0.0,,,0.0,119,4,0,4,-48,163,11
2020-05-21,aragon,Aragón,John Hopkins University,5618,858,0,256,30,10,0,1,-25.0,45.0,8,988,3772,2442,0.005368647100930657,0.011792452830188704,,0.0039215686274509665,-0.024679170779861814,0.012074054199087803,0.0032867707477404196,5588,848,0,255,1013,3727,2434
2020-05-21,pais_vasco,País Vasco,John Hopkins University,13454,1487,0,578,33,4,0,0,-103.0,132.0,8,-4193,16160,7032,0.002458833171894881,0.0026972353337828547,,0.0,,0.00823558772148747,0.001138952164009055,13421,1483,0,578,-4090,16028,7024
2020-05-21,la_rioja,La Rioja,John Hopkins University,4036,356,0,91,3,2,0,0,-58.0,59.0,5,573,3107,1504,0.0007438631291842857,0.005649717514124353,,0.0,-0.09191759112519815,0.019356955380577467,0.0033355570380253496,4033,354,0,91,631,3048,1499
2020-05-21,extremadura,Extremadura,John Hopkins University,3044,506,0,110,2,1,0,0,-15.0,16.0,0,-114,2652,1780,0.0006574621959236637,0.001980198019801982,,0.0,,0.006069802731411222,0.0,3042,505,0,110,-99,2636,1780
2020-05-21,cantabria,Cantabria,John Hopkins University,2284,209,0,79,5,0,0,0,-9.0,14.0,0,-212,2287,1036,0.0021939447125931544,0.0,,0.0,,0.006159260888693341,0.0,2279,209,0,79,-203,2273,1036
2020-05-22,castilla-la_mancha,Castilla-La Mancha,John Hopkins University,16855,2934,0,639,25,5,0,0,6,14.0,16,7529,6392,9138,0.0014854426619133054,0.0017070672584500457,,0.0,0.0007975541672204933,0.002195045468798895,0.0017540013155010747,16830,2929,0,639,7523,6378,9122
2020-05-22,navarra,Navarra,John Hopkins University,5205,509,0,136,5,1,0,0,-150,154.0,0,791,3905,2048,0.0009615384615384581,0.0019685039370078705,,0.0,-0.15940488841657807,0.04105571847507328,0.0,5200,508,0,136,941,3751,2048
2020-05-22,melilla,Melilla,John Hopkins University,121,2,0,3,0,0,0,0,-1,1.0,0,-6,125,44,0.0,0.0,,0.0,,0.008064516129032251,0.0,121,2,0,3,-5,124,44
2020-05-22,canarias,Canarias,John Hopkins University,2321,157,0,179,9,2,0,0,-6,13.0,1,627,1537,944,0.0038927335640137617,0.012903225806451646,,0.0,-0.009478672985781977,0.00853018372703418,0.0010604453870626251,2312,155,0,179,633,1524,943
2020-05-22,baleares,Baleares,John Hopkins University,2039,222,0,169,2,0,0,1,-8,10.0,2,284,1533,1144,0.0009818360333824216,0.0,,0.005952380952380931,-0.0273972602739726,0.006565988181221227,0.0017513134851139256,2037,222,0,168,292,1523,1142
2020-05-22,murcia,Murcia,John Hopkins University,1575,149,0,112,3,0,0,0,-93,96.0,1,-754,2180,680,0.001908396946564972,0.0,,0.0,,0.04606525911708248,0.0014727540500736325,1572,149,0,112,-661,2084,679
2020-05-22,cataluna,Cataluña,John Hopkins University,57114,6663,0,2969,78,7,0,0,40,31.0,0,24248,26203,29497,0.0013675573322111667,0.0010516826923077094,,0.0,0.0016523463317912324,0.0011844719547609017,0.0,57036,6656,0,2969,24208,26172,29497
2020-05-22,c_valenciana,C. Valenciana,John Hopkins University,11051,1390,0,730,30,1,0,3,-34,63.0,5,-309,9970,5747,0.002722076036657306,0.0007199424046075986,,0.004126547455295837,,0.00635914000201887,0.0008707767328457461,11021,1389,0,727,-275,9907,5742
2020-05-22,asturias,Asturias,John Hopkins University,2377,307,0,121,1,0,0,0,-1,2.0,0,1007,1063,1089,0.00042087542087543284,0.0,,0.0,-0.0009920634920634885,0.0018850141376061114,0.0,2376,307,0,121,1008,1061,1089
2020-05-22,galicia,Galicia,John Hopkins University,9098,610,0,334,14,1,0,0,-36,49.0,4,-716,9204,2943,0.0015411712901804986,0.0016420361247948545,,0.0,,0.005352266521026827,0.0013610071452874184,9084,609,0,334,-680,9155,2939
2020-05-22,madrid,Madrid,John Hopkins University,67610,8956,0,3617,185,12,0,7,135,38.0,75,17918,40736,42497,0.002743789395624807,0.0013416815742397503,,0.0019390581717451116,0.007591519991002604,0.0009337068160597539,0.0017679505916741167,67425,8944,0,3610,17783,40698,42422
2020-05-22,andalucia,Andalucía,John Hopkins University,12597,1389,0,766,21,12,0,2,-51,60.0,14,537,10671,6210,0.0016698473282443782,0.008714596949890963,,0.002617801047120505,-0.08673469387755106,0.005654509471303415,0.002259522272433756,12576,1377,0,764,588,10611,6196
2020-05-22,castilla_y_leon,Castilla y León,John Hopkins University,18737,1961,0,561,63,0,0,6,63,,1,8060,8716,8735,0.0033736746278247853,0.0,,0.0108108108108107,0.007877954232837325,,0.00011449507671179582,18674,1961,0,555,7997,8716,8734
2020-05-22,ceuta,Ceuta,John Hopkins University,125,4,0,4,1,0,0,0,1,,0,-42,163,11,0.008064516129032251,0.0,,0.0,,,0.0,124,4,0,4,-43,163,11
2020-05-22,aragon,Aragón,John Hopkins University,5627,858,0,256,9,0,0,1,-36,45.0,8,997,3772,2442,0.00160199359202573,0.0,,0.0039215686274509665,-0.03484995159728943,0.012074054199087803,0.0032867707477404196,5618,858,0,255,1033,3727,2434
2020-05-22,pais_vasco,País Vasco,John Hopkins University,13467,1494,0,578,13,7,0,0,-126,132.0,8,-4187,16160,7032,0.0009662553887319625,0.00470746469401484,,0.0,,0.00823558772148747,0.001138952164009055,13454,1487,0,578,-4061,16028,7024
2020-05-22,la_rioja,La Rioja,John Hopkins University,4036,357,0,91,0,1,0,0,-60,59.0,5,572,3107,1504,0.0,0.002808988764045006,,0.0,-0.09493670886075944,0.019356955380577467,0.0033355570380253496,4036,356,0,91,632,3048,1499
2020-05-22,extremadura,Extremadura,John Hopkins University,3048,507,0,110,4,1,0,0,-13,16.0,0,-111,2652,1780,0.0013140604467805073,0.0019762845849802257,,0.0,,0.006069802731411222,0.0,3044,506,0,110,-98,2636,1780
2020-05-22,cantabria,Cantabria,John Hopkins University,2287,209,0,79,3,0,0,0,-11,14.0,0,-209,2287,1036,0.0013134851138354442,0.0,,0.0,,0.006159260888693341,0.0,2284,209,0,79,-198,2273,1036
2020-05-23,castilla-la_mancha,Castilla-La Mancha,John Hopkins University,16889,2940,0,639,34,6,0,0,14.0,14.0,16,7557,6392,9138,0.002017205576980041,0.002044989775051187,,0.0,0.0018560254540633814,0.002195045468798895,0.0017540013155010747,16855,2934,0,639,7543,6378,9122
2020-05-23,navarra,Navarra,John Hopkins University,5219,509,0,136,14,0,0,0,-140.0,154.0,0,805,3905,2048,0.0026897214217098675,0.0,,0.0,-0.14814814814814814,0.04105571847507328,0.0,5205,509,0,136,945,3751,2048
2020-05-23,melilla,Melilla,John Hopkins University,121,2,0,3,0,0,0,0,-1.0,1.0,0,-6,125,44,0.0,0.0,,0.0,,0.008064516129032251,0.0,121,2,0,3,-5,124,44
2020-05-23,canarias,Canarias,John Hopkins University,2322,157,0,179,1,0,0,0,-12.0,13.0,1,628,1537,944,0.0004308487720809939,0.0,,0.0,-0.018750000000000044,0.00853018372703418,0.0010604453870626251,2321,157,0,179,640,1524,943
2020-05-23,baleares,Baleares,John Hopkins University,2041,222,0,169,2,0,0,1,-8.0,10.0,2,286,1533,1144,0.0009808729769493763,0.0,,0.005952380952380931,-0.027210884353741527,0.006565988181221227,0.0017513134851139256,2039,222,0,168,294,1523,1142
2020-05-23,murcia,Murcia,John Hopkins University,1579,149,0,112,4,0,0,0,-92.0,96.0,1,-750,2180,680,0.0025396825396826195,0.0,,0.0,,0.04606525911708248,0.0014727540500736325,1575,149,0,112,-658,2084,679
2020-05-23,cataluna,Cataluña,John Hopkins University,57148,6701,0,2969,34,38,0,0,-35.0,31.0,0,24244,26203,29497,0.0005953006268164529,0.005703136725198954,,0.0,-0.0014415750236830283,0.0011844719547609017,0.0,57114,6663,0,2969,24279,26172,29497
2020-05-23,c_valenciana,C. Valenciana,John Hopkins University,11073,1393,0,730,22,3,0,3,-44.0,63.0,5,-290,9970,5747,0.0019907700660573013,0.0021582733812950394,,0.004126547455295837,,0.00635914000201887,0.0008707767328457461,11051,1390,0,727,-246,9907,5742
2020-05-23,asturias,Asturias,John Hopkins University,2397,308,0,121,20,1,0,0,17.0,2.0,0,1026,1063,1089,0.008413967185527893,0.0032573289902280145,,0.0,0.01684836471754214,0.0018850141376061114,0.0,2377,307,0,121,1009,1061,1089
2020-05-23,galicia,Galicia,John Hopkins University,9105,613,0,334,7,3,0,0,-45.0,49.0,4,-712,9204,2943,0.0007693998681028713,0.004918032786885185,,0.0,,0.005352266521026827,0.0013610071452874184,9098,610,0,334,-667,9155,2939
2020-05-23,madrid,Madrid,John Hopkins University,67871,8977,0,3617,261,21,0,7,202.0,38.0,75,18158,40736,42497,0.003860375684070494,0.00234479678427868,,0.0019390581717451116,0.01124972154154591,0.0009337068160597539,0.0017679505916741167,67610,8956,0,3610,17956,40698,42422
2020-05-23,andalucia,Andalucía,John Hopkins University,12600,1391,0,766,3,2,0,2,-59.0,60.0,14,538,10671,6210,0.000238151940938236,0.0014398848092151972,,0.002617801047120505,-0.09882747068676712,0.005654509471303415,0.002259522272433756,12597,1389,0,764,597,10611,6196
2020-05-23,castilla_y_leon,Castilla y León,John Hopkins University,18789,1961,0,561,52,0,0,6,52.0,,1,8112,8716,8735,0.0027752575118749068,0.0,,0.0108108108108107,0.006451612903225712,,0.00011449507671179582,18737,1961,0,555,8060,8716,8734
2020-05-23,ceuta,Ceuta,John Hopkins University,125,4,0,4,0,0,0,0,,,0,-42,163,11,0.0,0.0,,0.0,,,0.0,125,4,0,4,-42,163,11
2020-05-23,aragon,Aragón,John Hopkins University,5646,858,0,256,19,0,0,1,-26.0,45.0,8,1016,3772,2442,0.0033765772169895847,0.0,,0.0039215686274509665,-0.0249520153550864,0.012074054199087803,0.0032867707477404196,5627,858,0,255,1042,3727,2434
2020-05-23,pais_vasco,País Vasco,John Hopkins University,13476,1494,0,578,9,0,0,0,-123.0,132.0,8,-4178,16160,7032,0.0006683002895968571,0.0,,0.0,,0.00823558772148747,0.001138952164009055,13467,1494,0,578,-4055,16028,7024
2020-05-23,la_rioja,La Rioja,John Hopkins University,4036,358,0,91,0,1,0,0,-60.0,59.0,5,571,3107,1504,0.0,0.0028011204481792618,,0.0,-0.09508716323296351,0.019356955380577467,0.0033355570380253496,4036,357,0,91,631,3048,1499
2020-05-23,extremadura,Extremadura,John Hopkins University,3048,507,0,110,0,0,0,0,-16.0,16.0,0,-111,2652,1780,0.0,0.0,,0.0,,0.006069802731411222,0.0,3048,507,0,110,-95,2636,1780
2020-05-23,cantabria,Cantabria,John Hopkins University,2289,209,0,79,2,0,0,0,-12.0,14.0,0,-207,2287,1036,0.0008745080891998658,0.0,,0.0,,0.006159260888693341,0.0,2287,209,0,79,-195,2273,1036
2020-05-24,castilla-la_mancha,Castilla-La Mancha,John Hopkins University,16909,2940,0,639,20,0,0,0,6.0,14.0,16,7577,6392,9138,0.001184202735508233,0.0,,0.0,0.0007924976885484991,0.002195045468798895,0.0017540013155010747,16889,2940,0,639,7571,6378,9122
2020-05-24,navarra,Navarra,John Hopkins University,5219,509,0,136,0,0,0,0,-154.0,154.0,0,805,3905,2048,0.0,0.0,,0.0,-0.16058394160583944,0.04105571847507328,0.0,5219,509,0,136,959,3751,2048
2020-05-24,melilla,Melilla,John Hopkins University,121,2,0,3,0,0,0,0,-1.0,1.0,0,-6,125,44,0.0,0.0,,0.0,,0.008064516129032251,0.0,121,2,0,3,-5,124,44
2020-05-24,canarias,Canarias,John Hopkins University,2322,157,0,179,0,0,0,0,-13.0,13.0,1,628,1537,944,0.0,0.0,,0.0,-0.020280811232449292,0.00853018372703418,0.0010604453870626251,2322,157,0,179,641,1524,943
2020-05-24,baleares,Baleares,John Hopkins University,2041,222,0,169,0,0,0,1,-10.0,10.0,2,286,1533,1144,0.0,0.0,,0.005952380952380931,-0.03378378378378377,0.006565988181221227,0.0017513134851139256,2041,222,0,168,296,1523,1142
2020-05-24,murcia,Murcia,John Hopkins University,1579,149,0,112,0,0,0,0,-96.0,96.0,1,-750,2180,680,0.0,0.0,,0.0,,0.04606525911708248,0.0014727540500736325,1579,149,0,112,-654,2084,679
2020-05-24,cataluna,Cataluña,John Hopkins University,57320,6701,0,2969,172,0,0,0,141.0,31.0,0,24416,26203,29497,0.0030097291243789126,0.0,,0.0,0.005808444902162702,0.0011844719547609017,0.0,57148,6701,0,2969,24275,26172,29497
2020-05-24,c_valenciana,C. Valenciana,John Hopkins University,11073,1393,0,730,0,0,0,3,-63.0,63.0,5,-290,9970,5747,0.0,0.0,,0.004126547455295837,,0.00635914000201887,0.0008707767328457461,11073,1393,0,727,-227,9907,5742
2020-05-24,asturias,Asturias,John Hopkins University,2397,308,0,121,0,0,0,0,-2.0,2.0,0,1026,1063,1089,0.0,0.0,,0.0,-0.0019455252918287869,0.0018850141376061114,0.0,2397,308,0,121,1028,1061,1089
2020-05-24,galicia,Galicia,John Hopkins University,9105,613,0,334,0,0,0,0,-49.0,49.0,4,-712,9204,2943,0.0,0.0,,0.0,,0.005352266521026827,0.0013610071452874184,9105,613,0,334,-663,9155,2939
2020-05-24,madrid,Madrid,John Hopkins University,67932,8977,0,3617,61,0,0,7,23.0,38.0,75,18219,40736,42497,0.0008987638313859847,0.0,,0.0019390581717451116,0.0012640140690260981,0.0009337068160597539,0.0017679505916741167,67871,8977,0,3610,18196,40698,42422
2020-05-24,andalucia,Andalucía,John Hopkins University,12600,1391,0,766,0,0,0,2,-60.0,60.0,14,538,10671,6210,0.0,0.0,,0.002617801047120505,-0.10033444816053516,0.005654509471303415,0.002259522272433756,12600,1391,0,764,598,10611,6196
2020-05-24,castilla_y_leon,Castilla y León,John Hopkins University,18789,1961,0,561,0,0,0,6,,,1,8112,8716,8735,0.0,0.0,,0.0108108108108107,,,0.00011449507671179582,18789,1961,0,555,8112,8716,8734
2020-05-24,ceuta,Ceuta,John Hopkins University,124,4,0,4,0,0,0,0,,,0,-43,163,11,0.0,0.0,,0.0,,,0.0,124,4,0,4,-43,163,11
2020-05-24,aragon,Aragón,John Hopkins University,5646,858,0,256,0,0,0,1,-45.0,45.0,8,1016,3772,2442,0.0,0.0,,0.0039215686274509665,-0.04241281809613573,0.012074054199087803,0.0032867707477404196,5646,858,0,255,1061,3727,2434
2020-05-24,pais_vasco,País Vasco,John Hopkins University,13478,1494,0,578,2,0,0,0,-130.0,132.0,8,-4176,16160,7032,0.00014841199168902364,0.0,,0.0,,0.00823558772148747,0.001138952164009055,13476,1494,0,578,-4046,16028,7024
2020-05-24,la_rioja,La Rioja,John Hopkins University,4041,358,0,91,5,0,0,0,-54.0,59.0,5,576,3107,1504,0.0012388503468780954,0.0,,0.0,-0.08571428571428574,0.019356955380577467,0.0033355570380253496,4036,358,0,91,630,3048,1499
2020-05-24,extremadura,Extremadura,John Hopkins University,3047,506,0,110,0,0,0,0,-16.0,16.0,0,-111,2652,1780,0.0,0.0,,0.0,,0.006069802731411222,0.0,3047,506,0,110,-95,2636,1780
2020-05-24,cantabria,Cantabria,John Hopkins University,2289,209,0,79,0,0,0,0,-14.0,14.0,0,-207,2287,1036,0.0,0.0,,0.0,,0.006159260888693341,0.0,2289,209,0,79,-193,2273,1036
2020-05-25,castilla-la_mancha,Castilla-La Mancha,John Hopkins University,16992,2945,0,639,83,157,0,0,-88,14.0,16,7655,6392,9138,0.004908628541013593,0.05631276901004312,,0.0,-0.011365103964871448,0.002195045468798895,0.0017540013155010747,16909,2788,0,639,7743,6378,9122
2020-05-25,navarra,Navarra,John Hopkins University,5199,490,0,136,4,0,0,0,-150,154.0,0,804,3905,2048,0.0007699711260826803,0.0,,0.0,-0.1572327044025157,0.04105571847507328,0.0,5195,490,0,136,954,3751,2048
2020-05-25,melilla,Melilla,John Hopkins University,121,2,0,3,0,0,0,0,-1,1.0,0,-6,125,44,0.0,0.0,,0.0,,0.008064516129032251,0.0,121,2,0,3,-5,124,44
2020-05-25,canarias,Canarias,John Hopkins University,2323,150,0,179,6,0,0,0,-7,13.0,1,636,1537,944,0.002589555459646009,0.0,,0.0,-0.010886469673405896,0.00853018372703418,0.0010604453870626251,2317,150,0,179,643,1524,943
2020-05-25,baleares,Baleares,John Hopkins University,2111,211,0,169,76,0,0,1,66,10.0,2,367,1533,1144,0.03734643734643739,0.0,,0.005952380952380931,0.21926910299003333,0.006565988181221227,0.0017513134851139256,2035,211,0,168,301,1523,1142
2020-05-25,murcia,Murcia,John Hopkins University,1587,148,0,112,14,9,0,0,-91,96.0,1,-741,2180,680,0.008900190718372558,0.06474820143884896,,0.0,,0.04606525911708248,0.0014727540500736325,1573,139,0,112,-650,2084,679
2020-05-25,cataluna,Cataluña,John Hopkins University,57569,5583,0,2969,249,8,0,0,210,31.0,0,25783,26203,29497,0.00434403349616197,0.0014349775784754382,,0.0,0.008211785867907606,0.0011844719547609017,0.0,57320,5575,0,2969,25573,26172,29497
2020-05-25,c_valenciana,C. Valenciana,John Hopkins University,11089,1332,0,730,33,1,0,3,-31,63.0,5,-213,9970,5747,0.0029848046309695064,0.0007513148009015147,,0.004126547455295837,,0.00635914000201887,0.0008707767328457461,11056,1331,0,727,-182,9907,5742
2020-05-25,asturias,Asturias,John Hopkins University,2399,310,0,121,19,22,0,0,-5,2.0,0,1026,1063,1089,0.007983193277310896,0.07638888888888884,,0.0,-0.004849660523763344,0.0018850141376061114,0.0,2380,288,0,121,1031,1061,1089
2020-05-25,galicia,Galicia,John Hopkins University,9108,607,0,334,29,0,0,0,-20,49.0,4,-703,9204,2943,0.003194184381539733,0.0,,0.0,,0.005352266521026827,0.0013610071452874184,9079,607,0,334,-683,9155,2939
2020-05-25,madrid,Madrid,John Hopkins University,68066,8691,0,3617,134,5,0,7,91,38.0,75,18639,40736,42497,0.001972560796090317,0.0005756389592448397,,0.0019390581717451116,0.004906189346560286,0.0009337068160597539,0.0017679505916741167,67932,8686,0,3610,18548,40698,42422
2020-05-25,andalucia,Andalucía,John Hopkins University,12612,1404,0,766,162,70,0,2,32,60.0,14,537,10671,6210,0.01301204819277113,0.052473763118440875,,0.002617801047120505,0.06336633663366342,0.005654509471303415,0.002259522272433756,12450,1334,0,764,505,10611,6196
2020-05-25,castilla_y_leon,Castilla y León,John Hopkins University,18591,1922,0,561,36,9,0,6,27,,1,7953,8716,8735,0.0019401778496361821,0.00470465237846307,,0.0108108108108107,0.003406510219530645,,0.00011449507671179582,18555,1913,0,555,7926,8716,8734
2020-05-25,ceuta,Ceuta,John Hopkins University,124,5,0,4,0,1,0,0,-1,,0,-44,163,11,0.0,0.25,,0.0,,,0.0,124,4,0,4,-43,163,11
2020-05-25,aragon,Aragón,John Hopkins University,5600,826,0,256,0,0,0,1,-45,45.0,8,1002,3772,2442,0.0,0.0,,0.0039215686274509665,-0.04297994269340977,0.012074054199087803,0.0032867707477404196,5600,826,0,255,1047,3727,2434
2020-05-25,pais_vasco,País Vasco,John Hopkins University,13486,1424,0,578,8,0,0,0,-124,132.0,8,-4098,16160,7032,0.0005935598753523674,0.0,,0.0,,0.00823558772148747,0.001138952164009055,13478,1424,0,578,-3974,16028,7024
2020-05-25,la_rioja,La Rioja,John Hopkins University,4044,360,0,91,3,2,0,0,-58,59.0,5,577,3107,1504,0.0007423904974015461,0.005586592178770999,,0.0,-0.09133858267716533,0.019356955380577467,0.0033355570380253496,4041,358,0,91,635,3048,1499
2020-05-25,extremadura,Extremadura,John Hopkins University,2955,507,0,110,3,1,0,0,-14,16.0,0,-204,2652,1780,0.00101626016260159,0.0019762845849802257,,0.0,,0.006069802731411222,0.0,2952,506,0,110,-190,2636,1780
2020-05-25,cantabria,Cantabria,John Hopkins University,2283,202,0,79,0,0,0,0,-14,14.0,0,-206,2287,1036,0.0,0.0,,0.0,,0.006159260888693341,0.0,2283,202,0,79,-192,2273,1036
2020-05-26,castilla-la_mancha,Castilla-La Mancha,John Hopkins University,16992,2945,0,639,0,0,0,0,-14.0,14.0,16,7655,6392,9138,0.0,0.0,,0.0,-0.0018255313600208378,0.002195045468798895,0.0017540013155010747,16992,2945,0,639,7669,6378,9122
2020-05-26,navarra,Navarra,John Hopkins University,5199,490,0,136,0,0,0,0,-154.0,154.0,0,804,3905,2048,0.0,0.0,,0.0,-0.16075156576200422,0.04105571847507328,0.0,5199,490,0,136,958,3751,2048
2020-05-26,melilla,Melilla,John Hopkins University,121,2,0,3,0,0,0,0,-1.0,1.0,0,-6,125,44,0.0,0.0,,0.0,,0.008064516129032251,0.0,121,2,0,3,-5,124,44
2020-05-26,canarias,Canarias,John Hopkins University,2323,150,0,179,0,0,0,0,-13.0,13.0,1,636,1537,944,0.0,0.0,,0.0,-0.02003081664098616,0.00853018372703418,0.0010604453870626251,2323,150,0,179,649,1524,943
2020-05-26,baleares,Baleares,John Hopkins University,2111,209,0,169,0,0,0,1,-10.0,10.0,2,369,1533,1144,0.0,0.0,,0.005952380952380931,-0.02638522427440637,0.006565988181221227,0.0017513134851139256,2111,209,0,168,379,1523,1142
2020-05-26,murcia,Murcia,John Hopkins University,1587,148,0,112,0,0,0,0,-96.0,96.0,1,-741,2180,680,0.0,0.0,,0.0,,0.04606525911708248,0.0014727540500736325,1587,148,0,112,-645,2084,679
2020-05-26,cataluna,Cataluña,John Hopkins University,57569,5583,0,2969,0,0,0,0,-31.0,31.0,0,25783,26203,29497,0.0,0.0,,0.0,-0.0012008987371193713,0.0011844719547609017,0.0,57569,5583,0,2969,25814,26172,29497
2020-05-26,c_valenciana,C. Valenciana,John Hopkins University,11089,1332,0,730,0,0,0,3,-63.0,63.0,5,-213,9970,5747,0.0,0.0,,0.004126547455295837,,0.00635914000201887,0.0008707767328457461,11089,1332,0,727,-150,9907,5742
2020-05-26,asturias,Asturias,John Hopkins University,2399,310,0,121,0,0,0,0,-2.0,2.0,0,1026,1063,1089,0.0,0.0,,0.0,-0.0019455252918287869,0.0018850141376061114,0.0,2399,310,0,121,1028,1061,1089
2020-05-26,galicia,Galicia,John Hopkins University,9108,607,0,334,0,0,0,0,-49.0,49.0,4,-703,9204,2943,0.0,0.0,,0.0,,0.005352266521026827,0.0013610071452874184,9108,607,0,334,-654,9155,2939
2020-05-26,madrid,Madrid,John Hopkins University,68066,8691,0,3617,0,0,0,7,-38.0,38.0,75,18639,40736,42497,0.0,0.0,,0.0019390581717451116,-0.0020345879959308144,0.0009337068160597539,0.0017679505916741167,68066,8691,0,3610,18677,40698,42422
2020-05-26,andalucia,Andalucía,John Hopkins University,12612,1404,0,766,0,0,0,2,-60.0,60.0,14,537,10671,6210,0.0,0.0,,0.002617801047120505,-0.10050251256281406,0.005654509471303415,0.002259522272433756,12612,1404,0,764,597,10611,6196
2020-05-26,castilla_y_leon,Castilla y León,John Hopkins University,18591,1922,0,561,0,0,0,6,,,1,7953,8716,8735,0.0,0.0,,0.0108108108108107,,,0.00011449507671179582,18591,1922,0,555,7953,8716,8734
2020-05-26,ceuta,Ceuta,John Hopkins University,124,5,0,4,0,0,0,0,,,0,-44,163,11,0.0,0.0,,0.0,,,0.0,124,5,0,4,-44,163,11
2020-05-26,aragon,Aragón,John Hopkins University,5600,826,0,256,0,0,0,1,-45.0,45.0,8,1002,3772,2442,0.0,0.0,,0.0039215686274509665,-0.04297994269340977,0.012074054199087803,0.0032867707477404196,5600,826,0,255,1047,3727,2434
2020-05-26,pais_vasco,País Vasco,John Hopkins University,13486,1424,0,578,0,0,0,0,-132.0,132.0,8,-4098,16160,7032,0.0,0.0,,0.0,,0.00823558772148747,0.001138952164009055,13486,1424,0,578,-3966,16028,7024
2020-05-26,la_rioja,La Rioja,John Hopkins University,4044,360,0,91,0,0,0,0,-59.0,59.0,5,577,3107,1504,0.0,0.0,,0.0,-0.09276729559748431,0.019356955380577467,0.0033355570380253496,4044,360,0,91,636,3048,1499
2020-05-26,extremadura,Extremadura,John Hopkins University,2955,507,0,110,0,0,0,0,-16.0,16.0,0,-204,2652,1780,0.0,0.0,,0.0,,0.006069802731411222,0.0,2955,507,0,110,-188,2636,1780
2020-05-26,cantabria,Cantabria,John Hopkins University,2283,202,0,79,0,0,0,0,-14.0,14.0,0,-206,2287,1036,0.0,0.0,,0.0,,0.006159260888693341,0.0,2283,202,0,79,-192,2273,1036
2020-05-27,castilla-la_mancha,Castilla-La Mancha,John Hopkins University,17068,2945,0,639,76,0,0,0,62.0,14.0,16,7731,6392,9138,0.00447269303201514,0.0,,0.0,0.008084496022949583,0.002195045468798895,0.0017540013155010747,16992,2945,0,639,7669,6378,9122
2020-05-27,navarra,Navarra,John Hopkins University,5223,490,0,136,24,0,0,0,-130.0,154.0,0,828,3905,2048,0.00461627236006934,0.0,,0.0,-0.13569937369519836,0.04105571847507328,0.0,5199,490,0,136,958,3751,2048
2020-05-27,melilla,Melilla,John Hopkins University,121,2,0,3,0,0,0,0,-1.0,1.0,0,-6,125,44,0.0,0.0,,0.0,,0.008064516129032251,0.0,121,2,0,3,-5,124,44
2020-05-27,canarias,Canarias,John Hopkins University,2327,151,0,179,4,1,0,0,-10.0,13.0,1,639,1537,944,0.0017219113215669601,0.006666666666666599,,0.0,-0.015408320493066285,0.00853018372703418,0.0010604453870626251,2323,150,0,179,649,1524,943
2020-05-27,baleares,Baleares,John Hopkins University,2124,209,0,169,13,0,0,1,3.0,10.0,2,382,1533,1144,0.006158218853623776,0.0,,0.005952380952380931,0.0079155672823219,0.006565988181221227,0.0017513134851139256,2111,209,0,168,379,1523,1142
2020-05-27,murcia,Murcia,John Hopkins University,1593,148,0,112,6,0,0,0,-90.0,96.0,1,-735,2180,680,0.003780718336483968,0.0,,0.0,,0.04606525911708248,0.0014727540500736325,1587,148,0,112,-645,2084,679
2020-05-27,cataluna,Cataluña,John Hopkins University,58427,5584,0,2969,858,1,0,0,826.0,31.0,0,26640,26203,29497,0.014903854505028846,0.00017911517105506647,,0.0,0.03199814054389094,0.0011844719547609017,0.0,57569,5583,0,2969,25814,26172,29497
2020-05-27,c_valenciana,C. Valenciana,John Hopkins University,11160,1332,0,730,71,0,0,3,8.0,63.0,5,-142,9970,5747,0.006402741455496352,0.0,,0.004126547455295837,,0.00635914000201887,0.0008707767328457461,11089,1332,0,727,-150,9907,5742
2020-05-27,asturias,Asturias,John Hopkins University,2400,310,0,121,1,0,0,0,-1.0,2.0,0,1027,1063,1089,0.00041684035014588616,0.0,,0.0,-0.0009727626459143934,0.0018850141376061114,0.0,2399,310,0,121,1028,1061,1089
2020-05-27,galicia,Galicia,John Hopkins University,9115,608,0,334,7,1,0,0,-43.0,49.0,4,-697,9204,2943,0.0007685551163811866,0.0016474464579900872,,0.0,,0.005352266521026827,0.0013610071452874184,9108,607,0,334,-654,9155,2939
2020-05-27,madrid,Madrid,John Hopkins University,68451,8691,0,3617,385,0,0,7,347.0,38.0,75,19024,40736,42497,0.005656274792113614,0.0,,0.0019390581717451116,0.018579000910210475,0.0009337068160597539,0.0017679505916741167,68066,8691,0,3610,18677,40698,42422
2020-05-27,andalucia,Andalucía,John Hopkins University,12639,1404,0,766,27,0,0,2,-33.0,60.0,14,564,10671,6210,0.002140818268315803,0.0,,0.002617801047120505,-0.055276381909547756,0.005654509471303415,0.002259522272433756,12612,1404,0,764,597,10611,6196
2020-05-27,castilla_y_leon,Castilla y León,John Hopkins University,18682,1922,0,561,91,0,0,6,91.0,,1,8044,8716,8735,0.004894841590016741,0.0,,0.0108108108108107,0.011442223060480261,,0.00011449507671179582,18591,1922,0,555,7953,8716,8734
2020-05-27,ceuta,Ceuta,John Hopkins University,129,5,0,4,5,0,0,0,5.0,,0,-39,163,11,0.040322580645161255,0.0,,0.0,,,0.0,124,5,0,4,-44,163,11
2020-05-27,aragon,Aragón,John Hopkins University,5656,826,0,256,56,0,0,1,11.0,45.0,8,1058,3772,2442,0.010000000000000009,0.0,,0.0039215686274509665,0.010506208213944657,0.012074054199087803,0.0032867707477404196,5600,826,0,255,1047,3727,2434
2020-05-27,pais_vasco,País Vasco,John Hopkins University,13489,1424,0,578,3,0,0,0,-129.0,132.0,8,-4095,16160,7032,0.0002224529141332532,0.0,,0.0,,0.00823558772148747,0.001138952164009055,13486,1424,0,578,-3966,16028,7024
2020-05-27,la_rioja,La Rioja,John Hopkins University,4044,360,0,91,0,0,0,0,-59.0,59.0,5,577,3107,1504,0.0,0.0,,0.0,-0.09276729559748431,0.019356955380577467,0.0033355570380253496,4044,360,0,91,636,3048,1499
2020-05-27,extremadura,Extremadura,John Hopkins University,2961,507,0,110,6,0,0,0,-10.0,16.0,0,-198,2652,1780,0.0020304568527917954,0.0,,0.0,,0.006069802731411222,0.0,2955,507,0,110,-188,2636,1780
2020-05-27,cantabria,Cantabria,John Hopkins University,2297,202,0,79,14,0,0,0,,14.0,0,-192,2287,1036,0.006132282084975849,0.0,,0.0,,0.006159260888693341,0.0,2283,202,0,79,-192,2273,1036
2020-05-28,castilla-la_mancha,Castilla-La Mancha,John Hopkins University,17122,2945,0,639,54,0,0,0,40,14.0,16,7785,6392,9138,0.003163815326927555,0.0,,0.0,0.005164622336991664,0.002195045468798895,0.0017540013155010747,17068,2945,0,639,7745,6378,9122
2020-05-28,navarra,Navarra,John Hopkins University,5238,490,0,136,15,0,0,0,-139,154.0,0,843,3905,2048,0.0028719126938541173,0.0,,0.0,-0.14154786150712828,0.04105571847507328,0.0,5223,490,0,136,982,3751,2048
2020-05-28,melilla,Melilla,John Hopkins University,121,2,0,3,0,0,0,0,-1,1.0,0,-6,125,44,0.0,0.0,,0.0,,0.008064516129032251,0.0,121,2,0,3,-5,124,44
2020-05-28,canarias,Canarias,John Hopkins University,2333,151,0,179,6,0,0,0,-7,13.0,1,645,1537,944,0.0025784271594326835,0.0,,0.0,-0.010736196319018454,0.00853018372703418,0.0010604453870626251,2327,151,0,179,652,1524,943
2020-05-28,baleares,Baleares,John Hopkins University,2129,209,0,169,5,0,0,1,-5,10.0,2,387,1533,1144,0.002354048964218425,0.0,,0.005952380952380931,-0.012755102040816313,0.006565988181221227,0.0017513134851139256,2124,209,0,168,392,1523,1142
2020-05-28,murcia,Murcia,John Hopkins University,1595,148,0,112,2,0,0,0,-94,96.0,1,-733,2180,680,0.0012554927809165228,0.0,,0.0,,0.04606525911708248,0.0014727540500736325,1593,148,0,112,-639,2084,679
2020-05-28,cataluna,Cataluña,John Hopkins University,58699,5584,0,2969,272,0,0,0,241,31.0,0,26912,26203,29497,0.0046553819295873655,0.0,,0.0,0.009036031644857667,0.0011844719547609017,0.0,58427,5584,0,2969,26671,26172,29497
2020-05-28,c_valenciana,C. Valenciana,John Hopkins University,11191,1334,0,730,31,2,0,3,-34,63.0,5,-113,9970,5747,0.002777777777777768,0.0015015015015014122,,0.004126547455295837,,0.00635914000201887,0.0008707767328457461,11160,1332,0,727,-79,9907,5742
2020-05-28,asturias,Asturias,John Hopkins University,2401,310,0,121,1,0,0,0,-1,2.0,0,1028,1063,1089,0.0004166666666667318,0.0,,0.0,-0.0009718172983479434,0.0018850141376061114,0.0,2400,310,0,121,1029,1061,1089
2020-05-28,galicia,Galicia,John Hopkins University,9117,608,0,334,2,0,0,0,-47,49.0,4,-695,9204,2943,0.0002194185408666005,0.0,,0.0,,0.005352266521026827,0.0013610071452874184,9115,608,0,334,-648,9155,2939
2020-05-28,madrid,Madrid,John Hopkins University,68597,8691,0,3617,146,0,0,7,108,38.0,75,19170,40736,42497,0.0021329125944105076,0.0,,0.0019390581717451116,0.0056657223796034994,0.0009337068160597539,0.0017679505916741167,68451,8691,0,3610,19062,40698,42422
2020-05-28,andalucia,Andalucía,John Hopkins University,12655,1404,0,766,16,0,0,2,-44,60.0,14,580,10671,6210,0.0012659229369411662,0.0,,0.002617801047120505,-0.07051282051282048,0.005654509471303415,0.002259522272433756,12639,1404,0,764,624,10611,6196
2020-05-28,castilla_y_leon,Castilla y León,John Hopkins University,18747,1922,0,561,65,0,0,6,65,,1,8109,8716,8735,0.003479284873139976,0.0,,0.0108108108108107,0.008080556936847394,,0.00011449507671179582,18682,1922,0,555,8044,8716,8734
2020-05-28,ceuta,Ceuta,John Hopkins University,145,4,0,4,16,0,0,0,16,,0,-22,163,11,0.12403100775193798,0.0,,0.0,,,0.0,129,4,0,4,-38,163,11
2020-05-28,aragon,Aragón,John Hopkins University,5671,826,0,256,15,0,0,1,-30,45.0,8,1073,3772,2442,0.002652050919377702,0.0,,0.0039215686274509665,-0.027198549410698103,0.012074054199087803,0.0032867707477404196,5656,826,0,255,1103,3727,2434
2020-05-28,pais_vasco,País Vasco,John Hopkins University,13494,1424,0,578,5,0,0,0,-127,132.0,8,-4090,16160,7032,0.0003706723997332073,0.0,,0.0,,0.00823558772148747,0.001138952164009055,13489,1424,0,578,-3963,16028,7024
2020-05-28,la_rioja,La Rioja,John Hopkins University,4048,360,0,91,4,0,0,0,-55,59.0,5,581,3107,1504,0.0009891196834816984,0.0,,0.0,-0.08647798742138368,0.019356955380577467,0.0033355570380253496,4044,360,0,91,636,3048,1499
2020-05-28,extremadura,Extremadura,John Hopkins University,2963,507,0,110,2,0,0,0,-14,16.0,0,-196,2652,1780,0.0006754474839580915,0.0,,0.0,,0.006069802731411222,0.0,2961,507,0,110,-182,2636,1780
2020-05-28,cantabria,Cantabria,John Hopkins University,2298,202,0,79,1,0,0,0,-13,14.0,0,-191,2287,1036,0.0004353504571179556,0.0,,0.0,,0.006159260888693341,0.0,2297,202,0,79,-178,2273,1036
2020-05-29,castilla-la_mancha,Castilla-La Mancha,John Hopkins University,17184,2945,0,639,62,0,0,0,48.0,14.0,16,7847,6392,9138,0.003621072304637263,0.0,,0.0,0.006154635209642212,0.002195045468798895,0.0017540013155010747,17122,2945,0,639,7799,6378,9122
2020-05-29,navarra,Navarra,John Hopkins University,5247,490,0,136,9,0,0,0,-145.0,154.0,0,852,3905,2048,0.0017182130584192379,0.0,,0.0,-0.1454363089267804,0.04105571847507328,0.0,5238,490,0,136,997,3751,2048
2020-05-29,melilla,Melilla,John Hopkins University,121,2,0,3,0,0,0,0,-1.0,1.0,0,-6,125,44,0.0,0.0,,0.0,,0.008064516129032251,0.0,121,2,0,3,-5,124,44
2020-05-29,canarias,Canarias,John Hopkins University,2343,151,0,179,10,0,0,0,-3.0,13.0,1,655,1537,944,0.004286326618088365,0.0,,0.0,-0.00455927051671734,0.00853018372703418,0.0010604453870626251,2333,151,0,179,658,1524,943
2020-05-29,baleares,Baleares,John Hopkins University,2137,209,0,169,8,0,0,1,-2.0,10.0,2,395,1533,1144,0.003757632691404389,0.0,,0.005952380952380931,-0.005037783375314908,0.006565988181221227,0.0017513134851139256,2129,209,0,168,397,1523,1142
2020-05-29,murcia,Murcia,John Hopkins University,1597,148,0,112,2,0,0,0,-94.0,96.0,1,-731,2180,680,0.0012539184952977678,0.0,,0.0,,0.04606525911708248,0.0014727540500736325,1595,148,0,112,-637,2084,679
2020-05-29,cataluna,Cataluña,John Hopkins University,59003,5587,0,2969,304,3,0,0,270.0,31.0,0,27213,26203,29497,0.005178963866505404,0.0005372492836677178,,0.0,0.010021155773299206,0.0011844719547609017,0.0,58699,5584,0,2969,26943,26172,29497
2020-05-29,c_valenciana,C. Valenciana,John Hopkins University,11199,1334,0,730,8,0,0,3,-55.0,63.0,5,-105,9970,5747,0.0007148601554820555,0.0,,0.004126547455295837,,0.00635914000201887,0.0008707767328457461,11191,1334,0,727,-50,9907,5742
2020-05-29,asturias,Asturias,John Hopkins University,2421,310,0,121,20,0,0,0,18.0,2.0,0,1048,1063,1089,0.008329862557267864,0.0,,0.0,0.01747572815533971,0.0018850141376061114,0.0,2401,310,0,121,1030,1061,1089
2020-05-29,galicia,Galicia,John Hopkins University,9120,609,0,334,3,1,0,0,-47.0,49.0,4,-693,9204,2943,0.00032905561039808795,0.00164473684210531,,0.0,,0.005352266521026827,0.0013610071452874184,9117,608,0,334,-646,9155,2939
2020-05-29,madrid,Madrid,John Hopkins University,68740,8691,0,3617,143,0,0,7,105.0,38.0,75,19313,40736,42497,0.0020846392699389593,0.0,,0.0019390581717451116,0.0054664723032069595,0.0009337068160597539,0.0017679505916741167,68597,8691,0,3610,19208,40698,42422
2020-05-29,andalucia,Andalucía,John Hopkins University,12668,1404,0,766,13,0,0,2,-47.0,60.0,14,593,10671,6210,0.0010272619517976977,0.0,,0.002617801047120505,-0.07343750000000004,0.005654509471303415,0.002259522272433756,12655,1404,0,764,640,10611,6196
2020-05-29,castilla_y_leon,Castilla y León,John Hopkins University,18804,1923,0,561,57,1,0,6,56.0,,1,8165,8716,8735,0.0030404864778363905,0.0005202913631634498,,0.0108108108108107,0.006905907016894863,,0.00011449507671179582,18747,1922,0,555,8109,8716,8734
2020-05-29,ceuta,Ceuta,John Hopkins University,145,4,0,4,0,0,0,0,,,0,-22,163,11,0.0,0.0,,0.0,,,0.0,145,4,0,4,-22,163,11
2020-05-29,aragon,Aragón,John Hopkins University,5680,826,0,256,9,0,0,1,-36.0,45.0,8,1082,3772,2442,0.001587021689296364,0.0,,0.0039215686274509665,-0.03220035778175312,0.012074054199087803,0.0032867707477404196,5671,826,0,255,1118,3727,2434
2020-05-29,pais_vasco,País Vasco,John Hopkins University,13506,1424,0,578,12,0,0,0,-120.0,132.0,8,-4078,16160,7032,0.0008892841262784223,0.0,,0.0,,0.00823558772148747,0.001138952164009055,13494,1424,0,578,-3958,16028,7024
2020-05-29,la_rioja,La Rioja,John Hopkins University,4051,360,0,91,3,0,0,0,-56.0,59.0,5,584,3107,1504,0.0007411067193676679,0.0,,0.0,-0.08750000000000002,0.019356955380577467,0.0033355570380253496,4048,360,0,91,640,3048,1499
2020-05-29,extremadura,Extremadura,John Hopkins University,2964,508,0,110,1,1,0,0,-16.0,16.0,0,-196,2652,1780,0.0003374957813027102,0.0019723865877712132,,0.0,,0.006069802731411222,0.0,2963,507,0,110,-180,2636,1780
2020-05-29,cantabria,Cantabria,John Hopkins University,2298,202,0,79,0,0,0,0,-14.0,14.0,0,-191,2287,1036,0.0,0.0,,0.0,,0.006159260888693341,0.0,2298,202,0,79,-177,2273,1036
2020-05-30,castilla-la_mancha,Castilla-La Mancha,John Hopkins University,17234,2945,0,639,50,0,0,0,36.0,14.0,16,7897,6392,9138,0.002909683426443266,0.0,,0.0,0.004579570029258351,0.002195045468798895,0.0017540013155010747,17184,2945,0,639,7861,6378,9122
2020-05-30,navarra,Navarra,John Hopkins University,5254,490,0,136,7,0,0,0,-147.0,154.0,0,859,3905,2048,0.0013340956737182275,0.0,,0.0,-0.14612326043737578,0.04105571847507328,0.0,5247,490,0,136,1006,3751,2048
2020-05-30,melilla,Melilla,John Hopkins University,121,2,0,3,0,0,0,0,-1.0,1.0,0,-6,125,44,0.0,0.0,,0.0,,0.008064516129032251,0.0,121,2,0,3,-5,124,44
2020-05-30,canarias,Canarias,John Hopkins University,2345,151,0,179,2,0,0,0,-11.0,13.0,1,657,1537,944,0.0008536064874093974,0.0,,0.0,-0.01646706586826352,0.00853018372703418,0.0010604453870626251,2343,151,0,179,668,1524,943
2020-05-30,baleares,Baleares,John Hopkins University,2141,209,0,169,4,0,0,1,-6.0,10.0,2,399,1533,1144,0.0018717828731866781,0.0,,0.005952380952380931,-0.014814814814814836,0.006565988181221227,0.0017513134851139256,2137,209,0,168,405,1523,1142
2020-05-30,murcia,Murcia,John Hopkins University,1597,148,0,112,0,0,0,0,-96.0,96.0,1,-731,2180,680,0.0,0.0,,0.0,,0.04606525911708248,0.0014727540500736325,1597,148,0,112,-635,2084,679
2020-05-30,cataluna,Cataluña,John Hopkins University,59013,5587,0,2969,10,0,0,0,-21.0,31.0,0,27223,26203,29497,0.00016948290764884355,0.0,,0.0,-0.0007708119218911014,0.0011844719547609017,0.0,59003,5587,0,2969,27244,26172,29497
2020-05-30,c_valenciana,C. Valenciana,John Hopkins University,11201,1332,0,730,2,0,0,3,-61.0,63.0,5,-101,9970,5747,0.00017858737387266288,0.0,,0.004126547455295837,,0.00635914000201887,0.0008707767328457461,11199,1332,0,727,-40,9907,5742
2020-05-30,asturias,Asturias,John Hopkins University,2424,310,0,121,3,0,0,0,1.0,2.0,0,1051,1063,1089,0.0012391573729864103,0.0,,0.0,0.0009523809523810378,0.0018850141376061114,0.0,2421,310,0,121,1050,1061,1089
2020-05-30,galicia,Galicia,John Hopkins University,9120,609,0,334,0,0,0,0,-49.0,49.0,4,-693,9204,2943,0.0,0.0,,0.0,,0.005352266521026827,0.0013610071452874184,9120,609,0,334,-644,9155,2939
2020-05-30,madrid,Madrid,John Hopkins University,68830,8691,0,3617,90,0,0,7,52.0,38.0,75,19403,40736,42497,0.0013092813500146239,0.0,,0.0019390581717451116,0.0026871996279262955,0.0009337068160597539,0.0017679505916741167,68740,8691,0,3610,19351,40698,42422
2020-05-30,andalucia,Andalucía,John Hopkins University,12673,1404,0,766,5,0,0,2,-55.0,60.0,14,598,10671,6210,0.0003946952952320615,0.0,,0.002617801047120505,-0.08422664624808573,0.005654509471303415,0.002259522272433756,12668,1404,0,764,653,10611,6196
2020-05-30,castilla_y_leon,Castilla y León,John Hopkins University,18863,1924,0,561,59,1,0,6,58.0,,1,8223,8716,8735,0.00313763029142744,0.0005200208008320217,,0.0108108108108107,0.007103490508266974,,0.00011449507671179582,18804,1923,0,555,8165,8716,8734
2020-05-30,ceuta,Ceuta,John Hopkins University,145,4,0,4,0,0,0,0,,,0,-22,163,11,0.0,0.0,,0.0,,,0.0,145,4,0,4,-22,163,11
2020-05-30,aragon,Aragón,John Hopkins University,5691,826,0,256,11,0,0,1,-34.0,45.0,8,1093,3772,2442,0.0019366197183099398,0.0,,0.0039215686274509665,-0.030168589174800364,0.012074054199087803,0.0032867707477404196,5680,826,0,255,1127,3727,2434
2020-05-30,pais_vasco,País Vasco,John Hopkins University,13508,1424,0,578,2,0,0,0,-130.0,132.0,8,-4076,16160,7032,0.00014808233377761049,0.0,,0.0,,0.00823558772148747,0.001138952164009055,13506,1424,0,578,-3946,16028,7024
2020-05-30,la_rioja,La Rioja,John Hopkins University,4051,361,0,91,0,1,0,0,-60.0,59.0,5,583,3107,1504,0.0,0.002777777777777768,,0.0,-0.09331259720062213,0.019356955380577467,0.0033355570380253496,4051,360,0,91,643,3048,1499
2020-05-30,extremadura,Extremadura,John Hopkins University,2966,508,0,110,2,0,0,0,-14.0,16.0,0,-194,2652,1780,0.0006747638326585204,0.0,,0.0,,0.006069802731411222,0.0,2964,508,0,110,-180,2636,1780
2020-05-30,cantabria,Cantabria,John Hopkins University,2303,202,0,79,5,0,0,0,-9.0,14.0,0,-186,2287,1036,0.0021758050478677404,0.0,,0.0,,0.006159260888693341,0.0,2298,202,0,79,-177,2273,1036
2020-05-31,castilla-la_mancha,Castilla-La Mancha,John Hopkins University,17259,2945,0,639,25,0,0,0,11,14.0,16,7922,6392,9138,0.0014506208657305564,0.0,,0.0,0.001390468967260805,0.002195045468798895,0.0017540013155010747,17234,2945,0,639,7911,6378,9122
2020-05-31,navarra,Navarra,John Hopkins University,5259,490,0,136,5,0,0,0,-149,154.0,0,864,3905,2048,0.0009516558812332487,0.0,,0.0,-0.1470878578479763,0.04105571847507328,0.0,5254,490,0,136,1013,3751,2048
2020-05-31,melilla,Melilla,John Hopkins University,121,2,0,3,0,0,0,0,-1,1.0,0,-6,125,44,0.0,0.0,,0.0,,0.008064516129032251,0.0,121,2,0,3,-5,124,44
2020-05-31,canarias,Canarias,John Hopkins University,2347,151,0,179,2,0,0,0,-11,13.0,1,659,1537,944,0.0008528784648187404,0.0,,0.0,-0.016417910447761197,0.00853018372703418,0.0010604453870626251,2345,151,0,179,670,1524,943
2020-05-31,baleares,Baleares,John Hopkins University,2142,209,0,169,1,0,0,1,-9,10.0,2,400,1533,1144,0.0004670714619336991,0.0,,0.005952380952380931,-0.022004889975550168,0.006565988181221227,0.0017513134851139256,2141,209,0,168,409,1523,1142
2020-05-31,murcia,Murcia,John Hopkins University,1599,148,0,112,2,0,0,0,-94,96.0,1,-729,2180,680,0.0012523481527864089,0.0,,0.0,,0.04606525911708248,0.0014727540500736325,1597,148,0,112,-635,2084,679
2020-05-31,cataluna,Cataluña,John Hopkins University,59019,5587,0,2969,6,0,0,0,-25,31.0,0,27229,26203,29497,0.00010167251283621503,0.0,,0.0,-0.0009172965436266001,0.0011844719547609017,0.0,59013,5587,0,2969,27254,26172,29497
2020-05-31,c_valenciana,C. Valenciana,John Hopkins University,11228,1332,0,730,27,0,0,3,-36,63.0,5,-74,9970,5747,0.0024104990625837264,0.0,,0.004126547455295837,,0.00635914000201887,0.0008707767328457461,11201,1332,0,727,-38,9907,5742
2020-05-31,asturias,Asturias,John Hopkins University,2425,310,0,121,1,0,0,0,-1,2.0,0,1052,1063,1089,0.0004125412541253759,0.0,,0.0,-0.0009496676163343043,0.0018850141376061114,0.0,2424,310,0,121,1053,1061,1089
2020-05-31,galicia,Galicia,John Hopkins University,9129,609,0,334,10,0,0,0,-39,49.0,4,-684,9204,2943,0.0010966114705559526,0.0,,0.0,,0.005352266521026827,0.0013610071452874184,9119,609,0,334,-645,9155,2939
2020-05-31,madrid,Madrid,John Hopkins University,68852,8691,0,3617,22,0,0,7,-16,38.0,75,19425,40736,42497,0.00031962806915597497,0.0,,0.0019390581717451116,-0.0008230029319479248,0.0009337068160597539,0.0017679505916741167,68830,8691,0,3610,19441,40698,42422
2020-05-31,andalucia,Andalucía,John Hopkins University,12679,1404,0,766,6,0,0,2,-54,60.0,14,604,10671,6210,0.0004734474867829075,0.0,,0.002617801047120505,-0.0820668693009119,0.005654509471303415,0.002259522272433756,12673,1404,0,764,658,10611,6196
2020-05-31,castilla_y_leon,Castilla y León,John Hopkins University,18907,1924,0,561,44,0,0,6,44,,1,8267,8716,8735,0.0023326088108996945,0.0,,0.0108108108108107,0.0053508451903199195,,0.00011449507671179582,18863,1924,0,555,8223,8716,8734
2020-05-31,ceuta,Ceuta,John Hopkins University,146,4,0,4,1,0,0,0,1,,0,-21,163,11,0.006896551724137945,0.0,,0.0,,,0.0,145,4,0,4,-22,163,11
2020-05-31,aragon,Aragón,John Hopkins University,5695,826,0,256,4,0,0,1,-41,45.0,8,1097,3772,2442,0.0007028641714987849,0.0,,0.0039215686274509665,-0.03602811950790863,0.012074054199087803,0.0032867707477404196,5691,826,0,255,1138,3727,2434
2020-05-31,pais_vasco,País Vasco,John Hopkins University,13511,1424,0,578,3,0,0,0,-129,132.0,8,-4073,16160,7032,0.00022209061297018273,0.0,,0.0,,0.00823558772148747,0.001138952164009055,13508,1424,0,578,-3944,16028,7024
2020-05-31,la_rioja,La Rioja,John Hopkins University,4051,361,0,91,0,0,0,0,-59,59.0,5,583,3107,1504,0.0,0.0,,0.0,-0.0919003115264797,0.019356955380577467,0.0033355570380253496,4051,361,0,91,642,3048,1499
2020-05-31,extremadura,Extremadura,John Hopkins University,2966,508,0,110,0,0,0,0,-16,16.0,0,-194,2652,1780,0.0,0.0,,0.0,,0.006069802731411222,0.0,2966,508,0,110,-178,2636,1780
2020-05-31,cantabria,Cantabria,John Hopkins University,2303,202,0,79,0,0,0,0,-14,14.0,0,-186,2287,1036,0.0,0.0,,0.0,,0.006159260888693341,0.0,2303,202,0,79,-172,2273,1036
2020-06-01,castilla-la_mancha,Castilla-La Mancha,John Hopkins University,17310,2945,0,639,51,0,0,0,37.0,14.0,16,7973,6392,9138,0.0029549800104293755,0.0,,0.0,0.004662298387096753,0.002195045468798895,0.0017540013155010747,17259,2945,0,639,7936,6378,9122
2020-06-01,navarra,Navarra,John Hopkins University,5259,490,0,136,0,0,0,0,-154.0,154.0,0,864,3905,2048,0.0,0.0,,0.0,-0.15127701375245584,0.04105571847507328,0.0,5259,490,0,136,1018,3751,2048
2020-06-01,melilla,Melilla,John Hopkins University,122,2,0,3,1,0,0,0,,1.0,0,-5,125,44,0.008264462809917328,0.0,,0.0,,0.008064516129032251,0.0,121,2,0,3,-5,124,44
2020-06-01,canarias,Canarias,John Hopkins University,2351,151,0,179,4,0,0,0,-9.0,13.0,1,663,1537,944,0.001704303365999138,0.0,,0.0,-0.013392857142857095,0.00853018372703418,0.0010604453870626251,2347,151,0,179,672,1524,943
2020-06-01,baleares,Baleares,John Hopkins University,2150,209,0,169,8,0,0,1,-2.0,10.0,2,408,1533,1144,0.0037348272642390157,0.0,,0.005952380952380931,-0.004878048780487809,0.006565988181221227,0.0017513134851139256,2142,209,0,168,410,1523,1142
2020-06-01,murcia,Murcia,John Hopkins University,1603,148,0,112,4,0,0,0,-92.0,96.0,1,-725,2180,680,0.00250156347717323,0.0,,0.0,,0.04606525911708248,0.0014727540500736325,1599,148,0,112,-633,2084,679
2020-06-01,cataluna,Cataluña,John Hopkins University,59035,5587,0,2969,16,0,0,0,-15.0,31.0,0,27245,26203,29497,0.00027109913756584447,0.0,,0.0,-0.000550256786500336,0.0011844719547609017,0.0,59019,5587,0,2969,27260,26172,29497
2020-06-01,c_valenciana,C. Valenciana,John Hopkins University,11238,1332,0,730,10,0,0,3,-53.0,63.0,5,-64,9970,5747,0.0008906305664411196,0.0,,0.004126547455295837,,0.00635914000201887,0.0008707767328457461,11228,1332,0,727,-11,9907,5742
2020-06-01,asturias,Asturias,John Hopkins University,2425,310,0,121,0,0,0,0,-2.0,2.0,0,1052,1063,1089,0.0,0.0,,0.0,-0.00189753320683117,0.0018850141376061114,0.0,2425,310,0,121,1054,1061,1089
2020-06-01,galicia,Galicia,John Hopkins University,9130,609,0,334,1,0,0,0,-48.0,49.0,4,-683,9204,2943,0.00010954102311311331,0.0,,0.0,,0.005352266521026827,0.0013610071452874184,9129,609,0,334,-635,9155,2939
2020-06-01,madrid,Madrid,John Hopkins University,68960,8691,0,3617,108,0,0,7,70.0,38.0,75,19533,40736,42497,0.001568581885784015,0.0,,0.0019390581717451116,0.003596567846683385,0.0009337068160597539,0.0017679505916741167,68852,8691,0,3610,19463,40698,42422
2020-06-01,andalucia,Andalucía,John Hopkins University,12708,1404,0,766,29,0,0,2,-31.0,60.0,14,633,10671,6210,0.0022872466282830572,0.0,,0.002617801047120505,-0.04668674698795183,0.005654509471303415,0.002259522272433756,12679,1404,0,764,664,10611,6196
2020-06-01,castilla_y_leon,Castilla y León,John Hopkins University,18925,1924,0,561,18,0,0,6,18.0,,1,8285,8716,8735,0.0009520283492885362,0.0,,0.0108108108108107,0.002177331559211293,,0.00011449507671179582,18907,1924,0,555,8267,8716,8734
2020-06-01,ceuta,Ceuta,John Hopkins University,155,4,0,4,9,0,0,0,9.0,,0,-12,163,11,0.06164383561643838,0.0,,0.0,,,0.0,146,4,0,4,-21,163,11
2020-06-01,aragon,Aragón,John Hopkins University,5711,826,0,256,16,0,0,1,-29.0,45.0,8,1113,3772,2442,0.002809482001755903,0.0,,0.0039215686274509665,-0.02539404553415059,0.012074054199087803,0.0032867707477404196,5695,826,0,255,1142,3727,2434
2020-06-01,pais_vasco,País Vasco,John Hopkins University,13513,1424,0,578,2,0,0,0,-130.0,132.0,8,-4071,16160,7032,0.00014802753312115335,0.0,,0.0,,0.00823558772148747,0.001138952164009055,13511,1424,0,578,-3941,16028,7024
2020-06-01,la_rioja,La Rioja,John Hopkins University,4052,361,0,91,1,0,0,0,-58.0,59.0,5,584,3107,1504,0.0002468526289804984,0.0,,0.0,-0.09034267912772587,0.019356955380577467,0.0033355570380253496,4051,361,0,91,642,3048,1499
2020-06-01,extremadura,Extremadura,John Hopkins University,2971,508,0,110,5,0,0,0,-11.0,16.0,0,-189,2652,1780,0.001685772083614312,0.0,,0.0,,0.006069802731411222,0.0,2966,508,0,110,-178,2636,1780
2020-06-01,cantabria,Cantabria,John Hopkins University,2314,202,0,79,11,0,0,0,-3.0,14.0,0,-175,2287,1036,0.004776378636561107,0.0,,0.0,,0.006159260888693341,0.0,2303,202,0,79,-172,2273,1036
2020-06-02,castilla-la_mancha,Castilla-La Mancha,John Hopkins University,17310,2945,0,639,0,0,0,0,-14.0,14.0,16,7973,6392,9138,0.0,0.0,,0.0,-0.0017528483786152238,0.002195045468798895,0.0017540013155010747,17310,2945,0,639,7987,6378,9122
2020-06-02,navarra,Navarra,John Hopkins University,5259,490,0,136,0,0,0,0,-154.0,154.0,0,864,3905,2048,0.0,0.0,,0.0,-0.15127701375245584,0.04105571847507328,0.0,5259,490,0,136,1018,3751,2048
2020-06-02,melilla,Melilla,John Hopkins University,122,2,0,3,0,0,0,0,-1.0,1.0,0,-5,125,44,0.0,0.0,,0.0,,0.008064516129032251,0.0,122,2,0,3,-4,124,44
2020-06-02,canarias,Canarias,John Hopkins University,2351,151,0,179,0,0,0,0,-13.0,13.0,1,663,1537,944,0.0,0.0,,0.0,-0.019230769230769273,0.00853018372703418,0.0010604453870626251,2351,151,0,179,676,1524,943
2020-06-02,baleares,Baleares,John Hopkins University,2150,209,0,169,0,0,0,1,-10.0,10.0,2,408,1533,1144,0.0,0.0,,0.005952380952380931,-0.02392344497607657,0.006565988181221227,0.0017513134851139256,2150,209,0,168,418,1523,1142
2020-06-02,murcia,Murcia,John Hopkins University,1603,148,0,112,0,0,0,0,-96.0,96.0,1,-725,2180,680,0.0,0.0,,0.0,,0.04606525911708248,0.0014727540500736325,1603,148,0,112,-629,2084,679
2020-06-02,cataluna,Cataluña,John Hopkins University,59035,5587,0,2969,0,0,0,0,-31.0,31.0,0,27245,26203,29497,0.0,0.0,,0.0,-0.0011365302830327328,0.0011844719547609017,0.0,59035,5587,0,2969,27276,26172,29497
2020-06-02,c_valenciana,C. Valenciana,John Hopkins University,11238,1332,0,730,0,0,0,3,-63.0,63.0,5,-64,9970,5747,0.0,0.0,,0.004126547455295837,,0.00635914000201887,0.0008707767328457461,11238,1332,0,727,-1,9907,5742
2020-06-02,asturias,Asturias,John Hopkins University,2425,310,0,121,0,0,0,0,-2.0,2.0,0,1052,1063,1089,0.0,0.0,,0.0,-0.00189753320683117,0.0018850141376061114,0.0,2425,310,0,121,1054,1061,1089
2020-06-02,galicia,Galicia,John Hopkins University,9130,609,0,334,0,0,0,0,-49.0,49.0,4,-683,9204,2943,0.0,0.0,,0.0,,0.005352266521026827,0.0013610071452874184,9130,609,0,334,-634,9155,2939
2020-06-02,madrid,Madrid,John Hopkins University,68960,8691,0,3617,0,0,0,7,-38.0,38.0,75,19533,40736,42497,0.0,0.0,,0.0019390581717451116,-0.0019416483572632925,0.0009337068160597539,0.0017679505916741167,68960,8691,0,3610,19571,40698,42422
2020-06-02,andalucia,Andalucía,John Hopkins University,12708,1404,0,766,0,0,0,2,-60.0,60.0,14,633,10671,6210,0.0,0.0,,0.002617801047120505,-0.08658008658008653,0.005654509471303415,0.002259522272433756,12708,1404,0,764,693,10611,6196
2020-06-02,castilla_y_leon,Castilla y León,John Hopkins University,18925,1924,0,561,0,0,0,6,,,1,8285,8716,8735,0.0,0.0,,0.0108108108108107,,,0.00011449507671179582,18925,1924,0,555,8285,8716,8734
2020-06-02,ceuta,Ceuta,John Hopkins University,155,4,0,4,0,0,0,0,,,0,-12,163,11,0.0,0.0,,0.0,,,0.0,155,4,0,4,-12,163,11
2020-06-02,aragon,Aragón,John Hopkins University,5711,826,0,256,0,0,0,1,-45.0,45.0,8,1113,3772,2442,0.0,0.0,,0.0039215686274509665,-0.03886010362694303,0.012074054199087803,0.0032867707477404196,5711,826,0,255,1158,3727,2434
2020-06-02,pais_vasco,País Vasco,John Hopkins University,13513,1424,0,578,0,0,0,0,-132.0,132.0,8,-4071,16160,7032,0.0,0.0,,0.0,,0.00823558772148747,0.001138952164009055,13513,1424,0,578,-3939,16028,7024
2020-06-02,la_rioja,La Rioja,John Hopkins University,4052,361,0,91,0,0,0,0,-59.0,59.0,5,584,3107,1504,0.0,0.0,,0.0,-0.09175738724727833,0.019356955380577467,0.0033355570380253496,4052,361,0,91,643,3048,1499
2020-06-02,extremadura,Extremadura,John Hopkins University,2971,508,0,110,0,0,0,0,-16.0,16.0,0,-189,2652,1780,0.0,0.0,,0.0,,0.006069802731411222,0.0,2971,508,0,110,-173,2636,1780
2020-06-02,cantabria,Cantabria,John Hopkins University,2314,202,0,79,0,0,0,0,-14.0,14.0,0,-175,2287,1036,0.0,0.0,,0.0,,0.006159260888693341,0.0,2314,202,0,79,-161,2273,1036
2020-06-03,castilla-la_mancha,Castilla-La Mancha,John Hopkins University,17355,2945,0,639,45,0,0,0,31.0,14.0,16,8018,6392,9138,0.0025996533795493715,0.0,,0.0,0.0038813071240766384,0.002195045468798895,0.0017540013155010747,17310,2945,0,639,7987,6378,9122
2020-06-03,navarra,Navarra,John Hopkins University,5261,490,0,136,2,0,0,0,-152.0,154.0,0,866,3905,2048,0.00038030043734549324,0.0,,0.0,-0.14931237721021606,0.04105571847507328,0.0,5259,490,0,136,1018,3751,2048
2020-06-03,melilla,Melilla,John Hopkins University,122,2,0,3,0,0,0,0,-1.0,1.0,0,-5,125,44,0.0,0.0,,0.0,,0.008064516129032251,0.0,122,2,0,3,-4,124,44
2020-06-03,canarias,Canarias,John Hopkins University,2357,151,0,179,6,0,0,0,-7.0,13.0,1,669,1537,944,0.002552105487026779,0.0,,0.0,-0.010355029585798814,0.00853018372703418,0.0010604453870626251,2351,151,0,179,676,1524,943
2020-06-03,baleares,Baleares,John Hopkins University,2157,209,0,169,7,0,0,1,-3.0,10.0,2,415,1533,1144,0.0032558139534883956,0.0,,0.005952380952380931,-0.0071770334928229484,0.006565988181221227,0.0017513134851139256,2150,209,0,168,418,1523,1142
2020-06-03,murcia,Murcia,John Hopkins University,1605,148,0,112,2,0,0,0,-94.0,96.0,1,-723,2180,680,0.0012476606363069909,0.0,,0.0,,0.04606525911708248,0.0014727540500736325,1603,148,0,112,-629,2084,679
2020-06-03,cataluna,Cataluña,John Hopkins University,59112,5587,0,2969,77,0,0,0,46.0,31.0,0,27322,26203,29497,0.0013043110019479442,0.0,,0.0,0.0016864642909517613,0.0011844719547609017,0.0,59035,5587,0,2969,27276,26172,29497
2020-06-03,c_valenciana,C. Valenciana,John Hopkins University,11254,1332,0,730,16,0,0,3,-47.0,63.0,5,-48,9970,5747,0.0014237408791599737,0.0,,0.004126547455295837,,0.00635914000201887,0.0008707767328457461,11238,1332,0,727,-1,9907,5742
2020-06-03,asturias,Asturias,John Hopkins University,2425,310,0,121,0,0,0,0,-2.0,2.0,0,1052,1063,1089,0.0,0.0,,0.0,-0.00189753320683117,0.0018850141376061114,0.0,2425,310,0,121,1054,1061,1089
2020-06-03,galicia,Galicia,John Hopkins University,9132,609,0,334,2,0,0,0,-47.0,49.0,4,-681,9204,2943,0.00021905805038335835,0.0,,0.0,,0.005352266521026827,0.0013610071452874184,9130,609,0,334,-634,9155,2939
2020-06-03,madrid,Madrid,John Hopkins University,69112,8691,0,3617,152,0,0,7,114.0,38.0,75,19685,40736,42497,0.0022041763341067444,0.0,,0.0019390581717451116,0.005824945071789989,0.0009337068160597539,0.0017679505916741167,68960,8691,0,3610,19571,40698,42422
2020-06-03,andalucia,Andalucía,John Hopkins University,12726,1404,0,766,18,0,0,2,-42.0,60.0,14,651,10671,6210,0.0014164305949009304,0.0,,0.002617801047120505,-0.06060606060606055,0.005654509471303415,0.002259522272433756,12708,1404,0,764,693,10611,6196
2020-06-03,castilla_y_leon,Castilla y León,John Hopkins University,18956,1925,0,561,31,1,0,6,30.0,,1,8315,8716,8735,0.001638044914134662,0.0005197505197505059,,0.0108108108108107,0.0036210018105009567,,0.00011449507671179582,18925,1924,0,555,8285,8716,8734
2020-06-03,ceuta,Ceuta,John Hopkins University,155,4,0,4,0,0,0,0,,,0,-12,163,11,0.0,0.0,,0.0,,,0.0,155,4,0,4,-12,163,11
2020-06-03,aragon,Aragón,John Hopkins University,5731,826,0,256,20,0,0,1,-25.0,45.0,8,1133,3772,2442,0.003502013657853187,0.0,,0.0039215686274509665,-0.021588946459412783,0.012074054199087803,0.0032867707477404196,5711,826,0,255,1158,3727,2434
2020-06-03,pais_vasco,País Vasco,John Hopkins University,13523,1424,0,578,10,0,0,0,-122.0,132.0,8,-4061,16160,7032,0.0007400281210685478,0.0,,0.0,,0.00823558772148747,0.001138952164009055,13513,1424,0,578,-3939,16028,7024
2020-06-03,la_rioja,La Rioja,John Hopkins University,4053,361,0,91,1,0,0,0,-58.0,59.0,5,585,3107,1504,0.0002467917077986215,0.0,,0.0,-0.09020217729393465,0.019356955380577467,0.0033355570380253496,4052,361,0,91,643,3048,1499
2020-06-03,extremadura,Extremadura,John Hopkins University,2974,508,0,110,3,0,0,0,-13.0,16.0,0,-186,2652,1780,0.0010097610232244758,0.0,,0.0,,0.006069802731411222,0.0,2971,508,0,110,-173,2636,1780
2020-06-03,cantabria,Cantabria,John Hopkins University,2316,202,0,79,2,0,0,0,-12.0,14.0,0,-173,2287,1036,0.0008643042350906516,0.0,,0.0,,0.006159260888693341,0.0,2314,202,0,79,-161,2273,1036
2020-06-04,castilla-la_mancha,Castilla-La Mancha,John Hopkins University,17393,2945,0,639,38,0,0,0,24,14.0,16,8056,6392,9138,0.0021895707288965838,0.0,,0.0,0.0029880478087649376,0.002195045468798895,0.0017540013155010747,17355,2945,0,639,8032,6378,9122
2020-06-04,navarra,Navarra,John Hopkins University,5265,490,0,136,4,0,0,0,-150,154.0,0,870,3905,2048,0.0007603117278083271,0.0,,0.0,-0.1470588235294118,0.04105571847507328,0.0,5261,490,0,136,1020,3751,2048
2020-06-04,melilla,Melilla,John Hopkins University,122,2,0,3,0,0,0,0,-1,1.0,0,-5,125,44,0.0,0.0,,0.0,,0.008064516129032251,0.0,122,2,0,3,-4,124,44
2020-06-04,canarias,Canarias,John Hopkins University,2361,151,0,179,4,0,0,0,-9,13.0,1,673,1537,944,0.0016970725498515193,0.0,,0.0,-0.01319648093841641,0.00853018372703418,0.0010604453870626251,2357,151,0,179,682,1524,943
2020-06-04,baleares,Baleares,John Hopkins University,2164,209,0,169,7,0,0,1,-3,10.0,2,422,1533,1144,0.003245248029670744,0.0,,0.005952380952380931,-0.007058823529411784,0.006565988181221227,0.0017513134851139256,2157,209,0,168,425,1523,1142
2020-06-04,murcia,Murcia,John Hopkins University,1613,148,0,112,8,0,0,0,-88,96.0,1,-715,2180,680,0.004984423676012373,0.0,,0.0,,0.04606525911708248,0.0014727540500736325,1605,148,0,112,-627,2084,679
2020-06-04,cataluna,Cataluña,John Hopkins University,59163,5587,0,2969,51,0,0,0,20,31.0,0,27373,26203,29497,0.0008627689809175276,0.0,,0.0,0.0007311812232662085,0.0011844719547609017,0.0,59112,5587,0,2969,27353,26172,29497
2020-06-04,c_valenciana,C. Valenciana,John Hopkins University,11265,1332,0,730,11,0,0,3,-52,63.0,5,-37,9970,5747,0.0009774302470233476,0.0,,0.004126547455295837,-3.466666666666667,0.00635914000201887,0.0008707767328457461,11254,1332,0,727,15,9907,5742
2020-06-04,asturias,Asturias,John Hopkins University,2425,311,0,121,0,1,0,0,-3,2.0,0,1051,1063,1089,0.0,0.003225806451612856,,0.0,-0.002846299810246644,0.0018850141376061114,0.0,2425,310,0,121,1054,1061,1089
2020-06-04,galicia,Galicia,John Hopkins University,9134,609,0,334,2,0,0,0,-47,49.0,4,-679,9204,2943,0.00021901007446345488,0.0,,0.0,,0.005352266521026827,0.0013610071452874184,9132,609,0,334,-632,9155,2939
2020-06-04,madrid,Madrid,John Hopkins University,69236,8691,0,3617,124,0,0,7,86,38.0,75,19809,40736,42497,0.001794189142261926,0.0,,0.0019390581717451116,0.004360391421183385,0.0009337068160597539,0.0017679505916741167,69112,8691,0,3610,19723,40698,42422
2020-06-04,andalucia,Andalucía,John Hopkins University,12743,1404,0,766,17,0,0,2,-43,60.0,14,668,10671,6210,0.0013358478705012278,0.0,,0.002617801047120505,-0.06047819971870605,0.005654509471303415,0.002259522272433756,12726,1404,0,764,711,10611,6196
2020-06-04,castilla_y_leon,Castilla y León,John Hopkins University,19009,1928,0,561,53,3,0,6,50,,1,8365,8716,8735,0.002795948512344326,0.0015584415584415368,,0.0108108108108107,0.006013229104028905,,0.00011449507671179582,18956,1925,0,555,8315,8716,8734
2020-06-04,ceuta,Ceuta,John Hopkins University,163,4,0,4,8,0,0,0,8,,0,-4,163,11,0.05161290322580636,0.0,,0.0,,,0.0,155,4,0,4,-12,163,11
2020-06-04,aragon,Aragón,John Hopkins University,5734,826,0,256,3,0,0,1,-42,45.0,8,1136,3772,2442,0.000523468853603104,0.0,,0.0039215686274509665,-0.035653650254668934,0.012074054199087803,0.0032867707477404196,5731,826,0,255,1178,3727,2434
2020-06-04,pais_vasco,País Vasco,John Hopkins University,13527,1424,0,578,4,0,0,0,-128,132.0,8,-4057,16160,7032,0.00029579235376764323,0.0,,0.0,,0.00823558772148747,0.001138952164009055,13523,1424,0,578,-3929,16028,7024
2020-06-04,la_rioja,La Rioja,John Hopkins University,4054,362,0,91,1,1,0,0,-59,59.0,5,585,3107,1504,0.0002467308166789195,0.0027700831024930483,,0.0,-0.09161490683229812,0.019356955380577467,0.0033355570380253496,4053,361,0,91,644,3048,1499
2020-06-04,extremadura,Extremadura,John Hopkins University,2974,508,0,110,0,0,0,0,-16,16.0,0,-186,2652,1780,0.0,0.0,,0.0,,0.006069802731411222,0.0,2974,508,0,110,-170,2636,1780
2020-06-04,cantabria,Cantabria,John Hopkins University,2316,202,0,79,0,0,0,0,-14,14.0,0,-173,2287,1036,0.0,0.0,,0.0,,0.006159260888693341,0.0,2316,202,0,79,-159,2273,1036
2020-06-05,castilla-la_mancha,Castilla-La Mancha,John Hopkins University,17431,2945,0,639,38,0,0,0,24.0,14.0,16,8094,6392,9138,0.0021847869832691824,0.0,,0.0,0.0029739776951673846,0.002195045468798895,0.0017540013155010747,17393,2945,0,639,8070,6378,9122
2020-06-05,navarra,Navarra,John Hopkins University,5275,490,0,136,10,0,0,0,-144.0,154.0,0,880,3905,2048,0.0018993352326686086,0.0,,0.0,-0.140625,0.04105571847507328,0.0,5265,490,0,136,1024,3751,2048
2020-06-05,melilla,Melilla,John Hopkins University,122,2,0,3,0,0,0,0,-1.0,1.0,0,-5,125,44,0.0,0.0,,0.0,,0.008064516129032251,0.0,122,2,0,3,-4,124,44
2020-06-05,canarias,Canarias,John Hopkins University,2362,151,0,179,1,0,0,0,-12.0,13.0,1,674,1537,944,0.00042354934349853046,0.0,,0.0,-0.017492711370262426,0.00853018372703418,0.0010604453870626251,2361,151,0,179,686,1524,943
2020-06-05,baleares,Baleares,John Hopkins University,2164,209,0,169,0,0,0,1,-10.0,10.0,2,422,1533,1144,0.0,0.0,,0.005952380952380931,-0.02314814814814814,0.006565988181221227,0.0017513134851139256,2164,209,0,168,432,1523,1142
2020-06-05,murcia,Murcia,John Hopkins University,1616,148,0,112,3,0,0,0,-93.0,96.0,1,-712,2180,680,0.0018598884066955979,0.0,,0.0,,0.04606525911708248,0.0014727540500736325,1613,148,0,112,-619,2084,679
2020-06-05,cataluna,Cataluña,John Hopkins University,59182,5587,0,2969,19,0,0,0,-12.0,31.0,0,27392,26203,29497,0.0003211466626100723,0.0,,0.0,-0.000437892278499441,0.0011844719547609017,0.0,59163,5587,0,2969,27404,26172,29497
2020-06-05,c_valenciana,C. Valenciana,John Hopkins University,11285,1332,0,730,20,0,0,3,-43.0,63.0,5,-17,9970,5747,0.001775410563692903,0.0,,0.004126547455295837,-1.6538461538461537,0.00635914000201887,0.0008707767328457461,11265,1332,0,727,26,9907,5742
2020-06-05,asturias,Asturias,John Hopkins University,2425,312,0,121,0,1,0,0,-3.0,2.0,0,1050,1063,1089,0.0,0.003215434083601254,,0.0,-0.002849002849002802,0.0018850141376061114,0.0,2425,311,0,121,1053,1061,1089
2020-06-05,galicia,Galicia,John Hopkins University,9146,609,0,334,12,0,0,0,-37.0,49.0,4,-667,9204,2943,0.0013137727173198055,0.0,,0.0,,0.005352266521026827,0.0013610071452874184,9134,609,0,334,-630,9155,2939
2020-06-05,madrid,Madrid,John Hopkins University,69423,8691,0,3617,187,0,0,7,149.0,38.0,75,19996,40736,42497,0.0027009070425789705,0.0,,0.0019390581717451116,0.007507431853680746,0.0009337068160597539,0.0017679505916741167,69236,8691,0,3610,19847,40698,42422
2020-06-05,andalucia,Andalucía,John Hopkins University,12759,1404,0,766,16,0,0,2,-44.0,60.0,14,684,10671,6210,0.0012555913050302792,0.0,,0.002617801047120505,-0.06043956043956045,0.005654509471303415,0.002259522272433756,12743,1404,0,764,728,10611,6196
2020-06-05,castilla_y_leon,Castilla y León,John Hopkins University,19042,1928,0,561,33,0,0,6,33.0,,1,8398,8716,8735,0.001736019780104181,0.0,,0.0108108108108107,0.00394500896592942,,0.00011449507671179582,19009,1928,0,555,8365,8716,8734
2020-06-05,ceuta,Ceuta,John Hopkins University,163,4,0,4,0,0,0,0,,,0,-4,163,11,0.0,0.0,,0.0,,,0.0,163,4,0,4,-4,163,11
2020-06-05,aragon,Aragón,John Hopkins University,5757,826,0,256,23,0,0,1,-22.0,45.0,8,1159,3772,2442,0.004011161492849746,0.0,,0.0039215686274509665,-0.018628281117696877,0.012074054199087803,0.0032867707477404196,5734,826,0,255,1181,3727,2434
2020-06-05,pais_vasco,País Vasco,John Hopkins University,13529,1424,0,578,2,0,0,0,-130.0,132.0,8,-4055,16160,7032,0.00014785244326165348,0.0,,0.0,,0.00823558772148747,0.001138952164009055,13527,1424,0,578,-3925,16028,7024
2020-06-05,la_rioja,La Rioja,John Hopkins University,4056,362,0,91,2,0,0,0,-57.0,59.0,5,587,3107,1504,0.0004933399111988201,0.0,,0.0,-0.08850931677018636,0.019356955380577467,0.0033355570380253496,4054,362,0,91,644,3048,1499
2020-06-05,extremadura,Extremadura,John Hopkins University,2976,508,0,110,3,0,0,0,-13.0,16.0,0,-184,2652,1780,0.0010090817356205317,0.0,,0.0,,0.006069802731411222,0.0,2973,508,0,110,-171,2636,1780
2020-06-05,cantabria,Cantabria,John Hopkins University,2320,202,0,79,4,0,0,0,-10.0,14.0,0,-169,2287,1036,0.0017271157167531026,0.0,,0.0,,0.006159260888693341,0.0,2316,202,0,79,-159,2273,1036
2020-06-06,castilla-la_mancha,Castilla-La Mancha,John Hopkins University,17472,2945,0,639,41,0,0,0,27.0,14.0,16,8135,6392,9138,0.002352131260398238,0.0,,0.0,0.003330044400591925,0.002195045468798895,0.0017540013155010747,17431,2945,0,639,8108,6378,9122
2020-06-06,navarra,Navarra,John Hopkins University,5285,490,0,136,10,0,0,0,-144.0,154.0,0,890,3905,2048,0.0018957345971564177,0.0,,0.0,-0.13926499032882012,0.04105571847507328,0.0,5275,490,0,136,1034,3751,2048
2020-06-06,melilla,Melilla,John Hopkins University,122,2,0,3,0,0,0,0,-1.0,1.0,0,-5,125,44,0.0,0.0,,0.0,,0.008064516129032251,0.0,122,2,0,3,-4,124,44
2020-06-06,canarias,Canarias,John Hopkins University,2364,151,0,179,2,0,0,0,-11.0,13.0,1,676,1537,944,0.0008467400508043177,0.0,,0.0,-0.01601164483260553,0.00853018372703418,0.0010604453870626251,2362,151,0,179,687,1524,943
2020-06-06,baleares,Baleares,John Hopkins University,2118,209,0,169,8,0,0,1,-2.0,10.0,2,376,1533,1144,0.0037914691943128354,0.0,,0.005952380952380931,-0.005291005291005346,0.006565988181221227,0.0017513134851139256,2110,209,0,168,378,1523,1142
2020-06-06,murcia,Murcia,John Hopkins University,1616,148,0,112,0,0,0,0,-96.0,96.0,1,-712,2180,680,0.0,0.0,,0.0,,0.04606525911708248,0.0014727540500736325,1616,148,0,112,-616,2084,679
2020-06-06,cataluna,Cataluña,John Hopkins University,59199,5587,0,2969,17,0,0,0,-14.0,31.0,0,27409,26203,29497,0.00028724950153757867,0.0,,0.0,-0.0005105203661159852,0.0011844719547609017,0.0,59182,5587,0,2969,27423,26172,29497
2020-06-06,c_valenciana,C. Valenciana,John Hopkins University,11300,1332,0,730,15,0,0,3,-48.0,63.0,5,-2,9970,5747,0.0013291980505094614,0.0,,0.004126547455295837,-1.0434782608695652,0.00635914000201887,0.0008707767328457461,11285,1332,0,727,46,9907,5742
2020-06-06,asturias,Asturias,John Hopkins University,2426,313,0,121,2,1,0,0,-1.0,2.0,0,1050,1063,1089,0.0008250825082507518,0.0032051282051281937,,0.0,-0.0009514747859181716,0.0018850141376061114,0.0,2424,312,0,121,1051,1061,1089
2020-06-06,galicia,Galicia,John Hopkins University,9146,609,0,334,0,0,0,0,-49.0,49.0,4,-667,9204,2943,0.0,0.0,,0.0,,0.005352266521026827,0.0013610071452874184,9146,609,0,334,-618,9155,2939
2020-06-06,madrid,Madrid,John Hopkins University,69562,8691,0,3617,139,0,0,7,101.0,38.0,75,20135,40736,42497,0.002002218285006352,0.0,,0.0019390581717451116,0.005041429569731415,0.0009337068160597539,0.0017679505916741167,69423,8691,0,3610,20034,40698,42422
2020-06-06,andalucia,Andalucía,John Hopkins University,12776,1404,0,766,17,0,0,2,-43.0,60.0,14,701,10671,6210,0.0013323928207540359,0.0,,0.002617801047120505,-0.05779569892473113,0.005654509471303415,0.002259522272433756,12759,1404,0,764,744,10611,6196
2020-06-06,castilla_y_leon,Castilla y León,John Hopkins University,19104,1928,0,561,62,0,0,6,62.0,,1,8460,8716,8735,0.0032559605083499754,0.0,,0.0108108108108107,0.00738271016908798,,0.00011449507671179582,19042,1928,0,555,8398,8716,8734
2020-06-06,ceuta,Ceuta,John Hopkins University,163,4,0,4,0,0,0,0,,,0,-4,163,11,0.0,0.0,,0.0,,,0.0,163,4,0,4,-4,163,11
2020-06-06,aragon,Aragón,John Hopkins University,5770,826,0,256,13,0,0,1,-32.0,45.0,8,1172,3772,2442,0.002258120548896958,0.0,,0.0039215686274509665,-0.02657807308970095,0.012074054199087803,0.0032867707477404196,5757,826,0,255,1204,3727,2434
2020-06-06,pais_vasco,País Vasco,John Hopkins University,13535,1424,0,578,6,0,0,0,-126.0,132.0,8,-4049,16160,7032,0.000443491758444825,0.0,,0.0,,0.00823558772148747,0.001138952164009055,13529,1424,0,578,-3923,16028,7024
2020-06-06,la_rioja,La Rioja,John Hopkins University,4057,362,0,91,1,0,0,0,-58.0,59.0,5,588,3107,1504,0.0002465483234714849,0.0,,0.0,-0.08978328173374617,0.019356955380577467,0.0033355570380253496,4056,362,0,91,646,3048,1499
2020-06-06,extremadura,Extremadura,John Hopkins University,2977,508,0,110,1,0,0,0,-15.0,16.0,0,-183,2652,1780,0.0003360215053762605,0.0,,0.0,,0.006069802731411222,0.0,2976,508,0,110,-168,2636,1780
2020-06-06,cantabria,Cantabria,John Hopkins University,2320,202,0,79,0,0,0,0,-14.0,14.0,0,-169,2287,1036,0.0,0.0,,0.0,,0.006159260888693341,0.0,2320,202,0,79,-155,2273,1036
2020-06-07,castilla-la_mancha,Castilla-La Mancha,John Hopkins University,17505,2945,0,639,33,0,0,0,19.0,14.0,16,8168,6392,9138,0.0018887362637363125,0.0,,0.0,0.0023315744263099347,0.002195045468798895,0.0017540013155010747,17472,2945,0,639,8149,6378,9122
2020-06-07,navarra,Navarra,John Hopkins University,5288,490,0,136,3,0,0,0,-151.0,154.0,0,893,3905,2048,0.0005676442762534428,0.0,,0.0,-0.1446360153256705,0.04105571847507328,0.0,5285,490,0,136,1044,3751,2048
2020-06-07,melilla,Melilla,John Hopkins University,122,2,0,3,0,0,0,0,-1.0,1.0,0,-5,125,44,0.0,0.0,,0.0,,0.008064516129032251,0.0,122,2,0,3,-4,124,44
2020-06-07,canarias,Canarias,John Hopkins University,2369,151,0,179,5,0,0,0,-8.0,13.0,1,681,1537,944,0.002115059221658111,0.0,,0.0,-0.011611030478954953,0.00853018372703418,0.0010604453870626251,2364,151,0,179,689,1524,943
2020-06-07,baleares,Baleares,John Hopkins University,2125,209,0,169,7,0,0,1,-3.0,10.0,2,383,1533,1144,0.003305004721435356,0.0,,0.005952380952380931,-0.007772020725388629,0.006565988181221227,0.0017513134851139256,2118,209,0,168,386,1523,1142
2020-06-07,murcia,Murcia,John Hopkins University,1616,148,0,112,0,0,0,0,-96.0,96.0,1,-712,2180,680,0.0,0.0,,0.0,,0.04606525911708248,0.0014727540500736325,1616,148,0,112,-616,2084,679
2020-06-07,cataluna,Cataluña,John Hopkins University,59209,5587,0,2969,10,0,0,0,-21.0,31.0,0,27419,26203,29497,0.00016892177232730177,0.0,,0.0,-0.000765306122448961,0.0011844719547609017,0.0,59199,5587,0,2969,27440,26172,29497
2020-06-07,c_valenciana,C. Valenciana,John Hopkins University,11314,1332,0,730,14,0,0,3,-49.0,63.0,5,12,9970,5747,0.0012389380530972716,0.0,,0.004126547455295837,-0.8032786885245902,0.00635914000201887,0.0008707767328457461,11300,1332,0,727,61,9907,5742
2020-06-07,asturias,Asturias,John Hopkins University,2427,314,0,121,1,1,0,0,-2.0,2.0,0,1050,1063,1089,0.00041220115416318315,0.0031948881789136685,,0.0,-0.0019011406844106071,0.0018850141376061114,0.0,2426,313,0,121,1052,1061,1089
2020-06-07,galicia,Galicia,John Hopkins University,9145,609,0,334,1,0,0,0,-48.0,49.0,4,-668,9204,2943,0.00010936132983374591,0.0,,0.0,,0.005352266521026827,0.0013610071452874184,9144,609,0,334,-620,9155,2939
2020-06-07,madrid,Madrid,John Hopkins University,69641,8691,0,3617,79,0,0,7,41.0,38.0,75,20214,40736,42497,0.0011356775250854767,0.0,,0.0019390581717451116,0.0020324195707133175,0.0009337068160597539,0.0017679505916741167,69562,8691,0,3610,20173,40698,42422
2020-06-07,andalucia,Andalucía,John Hopkins University,12783,1404,0,766,7,0,0,2,-53.0,60.0,14,708,10671,6210,0.0005479023168439845,0.0,,0.002617801047120505,-0.06964520367936922,0.005654509471303415,0.002259522272433756,12776,1404,0,764,761,10611,6196
2020-06-07,castilla_y_leon,Castilla y León,John Hopkins University,19161,1928,0,561,57,0,0,6,57.0,,1,8517,8716,8735,0.0029836683417086007,0.0,,0.0108108108108107,0.006737588652482307,,0.00011449507671179582,19104,1928,0,555,8460,8716,8734
2020-06-07,ceuta,Ceuta,John Hopkins University,163,4,0,4,0,0,0,0,,,0,-4,163,11,0.0,0.0,,0.0,,,0.0,163,4,0,4,-4,163,11
2020-06-07,aragon,Aragón,John Hopkins University,5781,826,0,256,11,0,0,1,-34.0,45.0,8,1183,3772,2442,0.001906412478336117,0.0,,0.0039215686274509665,-0.0279375513557929,0.012074054199087803,0.0032867707477404196,5770,826,0,255,1217,3727,2434
2020-06-07,pais_vasco,País Vasco,John Hopkins University,13542,1424,0,578,7,0,0,0,-125.0,132.0,8,-4042,16160,7032,0.000517177687476833,0.0,,0.0,,0.00823558772148747,0.001138952164009055,13535,1424,0,578,-3917,16028,7024
2020-06-07,la_rioja,La Rioja,John Hopkins University,4061,362,0,91,4,0,0,0,-55.0,59.0,5,592,3107,1504,0.000985950209514419,0.0,,0.0,-0.08500772797527045,0.019356955380577467,0.0033355570380253496,4057,362,0,91,647,3048,1499
2020-06-07,extremadura,Extremadura,John Hopkins University,2977,508,0,110,0,0,0,0,-16.0,16.0,0,-183,2652,1780,0.0,0.0,,0.0,,0.006069802731411222,0.0,2977,508,0,110,-167,2636,1780
2020-06-07,cantabria,Cantabria,John Hopkins University,2321,202,0,79,1,0,0,0,-13.0,14.0,0,-168,2287,1036,0.0004310344827587187,0.0,,0.0,,0.006159260888693341,0.0,2320,202,0,79,-155,2273,1036
2020-06-08,castilla-la_mancha,Castilla-La Mancha,John Hopkins University,17543,2945,0,639,38,0,0,0,24.0,14.0,16,8206,6392,9138,0.0021708083404741174,0.0,,0.0,0.0029332681495966018,0.002195045468798895,0.0017540013155010747,17505,2945,0,639,8182,6378,9122
2020-06-08,navarra,Navarra,John Hopkins University,5294,490,0,136,6,0,0,0,-148.0,154.0,0,899,3905,2048,0.0011346444780635512,0.0,,0.0,-0.14135625596943646,0.04105571847507328,0.0,5288,490,0,136,1047,3751,2048
2020-06-08,melilla,Melilla,John Hopkins University,122,2,0,3,0,0,0,0,-1.0,1.0,0,-5,125,44,0.0,0.0,,0.0,,0.008064516129032251,0.0,122,2,0,3,-4,124,44
2020-06-08,canarias,Canarias,John Hopkins University,2370,151,0,179,1,0,0,0,-12.0,13.0,1,682,1537,944,0.00042211903756861346,0.0,,0.0,-0.01729106628242072,0.00853018372703418,0.0010604453870626251,2369,151,0,179,694,1524,943
2020-06-08,baleares,Baleares,John Hopkins University,2133,209,0,169,8,0,0,1,-2.0,10.0,2,391,1533,1144,0.0037647058823528923,0.0,,0.005952380952380931,-0.0050890585241730735,0.006565988181221227,0.0017513134851139256,2125,209,0,168,393,1523,1142
2020-06-08,murcia,Murcia,John Hopkins University,1619,148,0,112,3,0,0,0,-93.0,96.0,1,-709,2180,680,0.0018564356435644136,0.0,,0.0,,0.04606525911708248,0.0014727540500736325,1616,148,0,112,-616,2084,679
2020-06-08,cataluna,Cataluña,John Hopkins University,59215,5587,0,2969,6,0,0,0,-25.0,31.0,0,27425,26203,29497,0.00010133594554884162,0.0,,0.0,-0.0009107468123861207,0.0011844719547609017,0.0,59209,5587,0,2969,27450,26172,29497
2020-06-08,c_valenciana,C. Valenciana,John Hopkins University,11332,1332,0,730,18,0,0,3,-45.0,63.0,5,30,9970,5747,0.0015909492663956915,0.0,,0.004126547455295837,-0.6,0.00635914000201887,0.0008707767328457461,11314,1332,0,727,75,9907,5742
2020-06-08,asturias,Asturias,John Hopkins University,2429,314,0,121,2,0,0,0,,2.0,0,1052,1063,1089,0.0008240626287598918,0.0,,0.0,,0.0018850141376061114,0.0,2427,314,0,121,1052,1061,1089
2020-06-08,galicia,Galicia,John Hopkins University,9145,609,0,334,0,0,0,0,-49.0,49.0,4,-668,9204,2943,0.0,0.0,,0.0,,0.005352266521026827,0.0013610071452874184,9145,609,0,334,-619,9155,2939
2020-06-08,madrid,Madrid,John Hopkins University,69695,8691,0,3617,54,0,0,7,16.0,38.0,75,20268,40736,42497,0.0007754052928590216,0.0,,0.0019390581717451116,0.0007900454276121849,0.0009337068160597539,0.0017679505916741167,69641,8691,0,3610,20252,40698,42422
2020-06-08,andalucia,Andalucía,John Hopkins University,12785,1404,0,766,2,0,0,2,-58.0,60.0,14,710,10671,6210,0.0001564577955097679,0.0,,0.002617801047120505,-0.07552083333333337,0.005654509471303415,0.002259522272433756,12783,1404,0,764,768,10611,6196
2020-06-08,castilla_y_leon,Castilla y León,John Hopkins University,19181,1928,0,561,20,0,0,6,20.0,,1,8537,8716,8735,0.0010437868587234167,0.0,,0.0108108108108107,0.002348244687096379,,0.00011449507671179582,19161,1928,0,555,8517,8716,8734
2020-06-08,ceuta,Ceuta,John Hopkins University,163,4,0,4,0,0,0,0,,,0,-4,163,11,0.0,0.0,,0.0,,,0.0,163,4,0,4,-4,163,11
2020-06-08,aragon,Aragón,John Hopkins University,5785,826,0,256,4,0,0,1,-41.0,45.0,8,1187,3772,2442,0.0006919218128351723,0.0,,0.0039215686274509665,-0.03338762214983715,0.012074054199087803,0.0032867707477404196,5781,826,0,255,1228,3727,2434
2020-06-08,pais_vasco,País Vasco,John Hopkins University,13548,1424,0,578,6,0,0,0,-126.0,132.0,8,-4036,16160,7032,0.0004430660168364131,0.0,,0.0,,0.00823558772148747,0.001138952164009055,13542,1424,0,578,-3910,16028,7024
2020-06-08,la_rioja,La Rioja,John Hopkins University,4062,362,0,91,1,0,0,0,-58.0,59.0,5,593,3107,1504,0.0002462447672986201,0.0,,0.0,-0.08909370199692779,0.019356955380577467,0.0033355570380253496,4061,362,0,91,651,3048,1499
2020-06-08,extremadura,Extremadura,John Hopkins University,2977,508,0,110,0,0,0,0,-16.0,16.0,0,-183,2652,1780,0.0,0.0,,0.0,,0.006069802731411222,0.0,2977,508,0,110,-167,2636,1780
2020-06-08,cantabria,Cantabria,John Hopkins University,2323,202,0,79,2,0,0,0,-12.0,14.0,0,-166,2287,1036,0.0008616975441619878,0.0,,0.0,,0.006159260888693341,0.0,2321,202,0,79,-154,2273,1036
2020-06-09,castilla-la_mancha,Castilla-La Mancha,John Hopkins University,17609,2945,0,639,66,0,0,0,52.0,14.0,16,8272,6392,9138,0.003762184347033015,0.0,,0.0,0.006326034063260266,0.002195045468798895,0.0017540013155010747,17543,2945,0,639,8220,6378,9122
2020-06-09,navarra,Navarra,John Hopkins University,5295,490,0,136,1,0,0,0,-153.0,154.0,0,900,3905,2048,0.00018889308651304226,0.0,,0.0,-0.14529914529914534,0.04105571847507328,0.0,5294,490,0,136,1053,3751,2048
2020-06-09,melilla,Melilla,John Hopkins University,122,2,0,3,0,0,0,0,-1.0,1.0,0,-5,125,44,0.0,0.0,,0.0,,0.008064516129032251,0.0,122,2,0,3,-4,124,44
2020-06-09,canarias,Canarias,John Hopkins University,2372,151,0,179,2,0,0,0,-11.0,13.0,1,684,1537,944,0.0008438818565401629,0.0,,0.0,-0.015827338129496438,0.00853018372703418,0.0010604453870626251,2370,151,0,179,695,1524,943
2020-06-09,baleares,Baleares,John Hopkins University,2135,209,0,169,2,0,0,1,-8.0,10.0,2,393,1533,1144,0.0009376465072667983,0.0,,0.005952380952380931,-0.01995012468827928,0.006565988181221227,0.0017513134851139256,2133,209,0,168,401,1523,1142
2020-06-09,murcia,Murcia,John Hopkins University,1619,148,0,112,0,0,0,0,-96.0,96.0,1,-709,2180,680,0.0,0.0,,0.0,,0.04606525911708248,0.0014727540500736325,1619,148,0,112,-613,2084,679
2020-06-09,cataluna,Cataluña,John Hopkins University,59232,5587,0,2969,17,0,0,0,-14.0,31.0,0,27442,26203,29497,0.0002870894199105134,0.0,,0.0,-0.0005099067599068086,0.0011844719547609017,0.0,59215,5587,0,2969,27456,26172,29497
2020-06-09,c_valenciana,C. Valenciana,John Hopkins University,11342,1332,0,730,10,0,0,3,-53.0,63.0,5,40,9970,5747,0.0008824567596188437,0.0,,0.004126547455295837,-0.5698924731182795,0.00635914000201887,0.0008707767328457461,11332,1332,0,727,93,9907,5742
2020-06-09,asturias,Asturias,John Hopkins University,2430,314,0,121,1,0,0,0,-1.0,2.0,0,1053,1063,1089,0.0004116920543433267,0.0,,0.0,-0.000948766603415585,0.0018850141376061114,0.0,2429,314,0,121,1054,1061,1089
2020-06-09,galicia,Galicia,John Hopkins University,9148,609,0,334,7,0,0,0,-42.0,49.0,4,-665,9204,2943,0.0007657805491740888,0.0,,0.0,,0.005352266521026827,0.0013610071452874184,9141,609,0,334,-623,9155,2939
2020-06-09,madrid,Madrid,John Hopkins University,69804,8691,0,3617,109,0,0,7,71.0,38.0,75,20377,40736,42497,0.0015639572422698755,0.0,,0.0019390581717451116,0.0034965034965035446,0.0009337068160597539,0.0017679505916741167,69695,8691,0,3610,20306,40698,42422
2020-06-09,andalucia,Andalucía,John Hopkins University,12791,1404,0,766,6,0,0,2,-54.0,60.0,14,716,10671,6210,0.00046929996089173365,0.0,,0.002617801047120505,-0.07012987012987015,0.005654509471303415,0.002259522272433756,12785,1404,0,764,770,10611,6196
2020-06-09,castilla_y_leon,Castilla y León,John Hopkins University,19193,1928,0,561,12,0,0,6,12.0,,1,8549,8716,8735,0.0006256191022366853,0.0,,0.0108108108108107,0.0014056460114795222,,0.00011449507671179582,19181,1928,0,555,8537,8716,8734
2020-06-09,ceuta,Ceuta,John Hopkins University,163,4,0,4,0,0,0,0,,,0,-4,163,11,0.0,0.0,,0.0,,,0.0,163,4,0,4,-4,163,11
2020-06-09,aragon,Aragón,John Hopkins University,5792,826,0,256,7,0,0,1,-38.0,45.0,8,1194,3772,2442,0.001210025929127001,0.0,,0.0039215686274509665,-0.030844155844155896,0.012074054199087803,0.0032867707477404196,5785,826,0,255,1232,3727,2434
2020-06-09,pais_vasco,País Vasco,John Hopkins University,13555,1424,0,578,7,0,0,0,-125.0,132.0,8,-4029,16160,7032,0.0005166814289931931,0.0,,0.0,,0.00823558772148747,0.001138952164009055,13548,1424,0,578,-3904,16028,7024
2020-06-09,la_rioja,La Rioja,John Hopkins University,4062,362,0,91,0,0,0,0,-59.0,59.0,5,593,3107,1504,0.0,0.0,,0.0,-0.0904907975460123,0.019356955380577467,0.0033355570380253496,4062,362,0,91,652,3048,1499
2020-06-09,extremadura,Extremadura,John Hopkins University,2978,508,0,110,1,0,0,0,-15.0,16.0,0,-182,2652,1780,0.0003359086328518224,0.0,,0.0,,0.006069802731411222,0.0,2977,508,0,110,-167,2636,1780
2020-06-09,cantabria,Cantabria,John Hopkins University,2324,202,0,79,1,0,0,0,-13.0,14.0,0,-165,2287,1036,0.000430477830391629,0.0,,0.0,,0.006159260888693341,0.0,2323,202,0,79,-152,2273,1036
2020-06-10,castilla-la_mancha,Castilla-La Mancha,John Hopkins University,17640,2945,0,639,31,0,0,0,17.0,14.0,16,8303,6392,9138,0.001760463399397949,0.0,,0.0,0.0020516533912624535,0.002195045468798895,0.0017540013155010747,17609,2945,0,639,8286,6378,9122
2020-06-10,navarra,Navarra,John Hopkins University,5299,490,0,136,4,0,0,0,-150.0,154.0,0,904,3905,2048,0.0007554296506138147,0.0,,0.0,-0.14231499051233398,0.04105571847507328,0.0,5295,490,0,136,1054,3751,2048
2020-06-10,melilla,Melilla,John Hopkins University,122,2,0,3,0,0,0,0,-1.0,1.0,0,-5,125,44,0.0,0.0,,0.0,,0.008064516129032251,0.0,122,2,0,3,-4,124,44
2020-06-10,canarias,Canarias,John Hopkins University,2372,151,0,179,0,0,0,0,-13.0,13.0,1,684,1537,944,0.0,0.0,,0.0,-0.0186513629842181,0.00853018372703418,0.0010604453870626251,2372,151,0,179,697,1524,943
2020-06-10,baleares,Baleares,John Hopkins University,2137,209,0,169,2,0,0,1,-8.0,10.0,2,395,1533,1144,0.0009367681498828606,0.0,,0.005952380952380931,-0.01985111662531014,0.006565988181221227,0.0017513134851139256,2135,209,0,168,403,1523,1142
2020-06-10,murcia,Murcia,John Hopkins University,1624,148,0,112,5,0,0,0,-91.0,96.0,1,-704,2180,680,0.0030883261272389717,0.0,,0.0,,0.04606525911708248,0.0014727540500736325,1619,148,0,112,-613,2084,679
2020-06-10,cataluna,Cataluña,John Hopkins University,59298,5587,0,2969,66,0,0,0,35.0,31.0,0,27508,26203,29497,0.0011142625607780676,0.0,,0.0,0.001273978087576788,0.0011844719547609017,0.0,59232,5587,0,2969,27473,26172,29497
2020-06-10,c_valenciana,C. Valenciana,John Hopkins University,11361,1332,0,730,19,0,0,3,-44.0,63.0,5,59,9970,5747,0.0016751895609239398,0.0,,0.004126547455295837,-0.4271844660194175,0.00635914000201887,0.0008707767328457461,11342,1332,0,727,103,9907,5742
2020-06-10,asturias,Asturias,John Hopkins University,2431,314,0,121,1,0,0,0,-1.0,2.0,0,1054,1063,1089,0.0004115226337448874,0.0,,0.0,-0.0009478672985782088,0.0018850141376061114,0.0,2430,314,0,121,1055,1061,1089
2020-06-10,galicia,Galicia,John Hopkins University,9153,609,0,334,5,0,0,0,-44.0,49.0,4,-660,9204,2943,0.0005465675557498884,0.0,,0.0,,0.005352266521026827,0.0013610071452874184,9148,609,0,334,-616,9155,2939
2020-06-10,madrid,Madrid,John Hopkins University,69895,8691,0,3617,91,0,0,7,53.0,38.0,75,20468,40736,42497,0.0013036502206176248,0.0,,0.0019390581717451116,0.0025961302963506405,0.0009337068160597539,0.0017679505916741167,69804,8691,0,3610,20415,40698,42422
2020-06-10,andalucia,Andalucía,John Hopkins University,12800,1404,0,766,9,0,0,2,-51.0,60.0,14,725,10671,6210,0.0007036197326244498,0.0,,0.002617801047120505,-0.06572164948453607,0.005654509471303415,0.002259522272433756,12791,1404,0,764,776,10611,6196
2020-06-10,castilla_y_leon,Castilla y León,John Hopkins University,19222,1928,0,561,29,0,0,6,29.0,,1,8578,8716,8735,0.001510967540249153,0.0,,0.0108108108108107,0.003392209615159736,,0.00011449507671179582,19193,1928,0,555,8549,8716,8734
2020-06-10,ceuta,Ceuta,John Hopkins University,163,4,0,4,0,0,0,0,,,0,-4,163,11,0.0,0.0,,0.0,,,0.0,163,4,0,4,-4,163,11
2020-06-10,aragon,Aragón,John Hopkins University,5806,826,0,256,14,0,0,1,-31.0,45.0,8,1208,3772,2442,0.0024171270718231774,0.0,,0.0039215686274509665,-0.025020177562550483,0.012074054199087803,0.0032867707477404196,5792,826,0,255,1239,3727,2434
2020-06-10,pais_vasco,País Vasco,John Hopkins University,13588,1424,0,578,33,0,0,0,-99.0,132.0,8,-3996,16160,7032,0.0024345260051641393,0.0,,0.0,,0.00823558772148747,0.001138952164009055,13555,1424,0,578,-3897,16028,7024
2020-06-10,la_rioja,La Rioja,John Hopkins University,4063,362,0,91,1,0,0,0,-58.0,59.0,5,594,3107,1504,0.0002461841457410685,0.0,,0.0,-0.08895705521472397,0.019356955380577467,0.0033355570380253496,4062,362,0,91,652,3048,1499
2020-06-10,extremadura,Extremadura,John Hopkins University,2982,508,0,110,4,0,0,0,-12.0,16.0,0,-178,2652,1780,0.001343183344526544,0.0,,0.0,,0.006069802731411222,0.0,2978,508,0,110,-166,2636,1780
2020-06-10,cantabria,Cantabria,John Hopkins University,2324,202,0,79,0,0,0,0,-14.0,14.0,0,-165,2287,1036,0.0,0.0,,0.0,,0.006159260888693341,0.0,2324,202,0,79,-151,2273,1036
2020-06-11,castilla-la_mancha,Castilla-La Mancha,John Hopkins University,17702,2945,0,639,62,0,0,0,48.0,14.0,16,8365,6392,9138,0.003514739229024899,0.0,,0.0,0.005771311771071375,0.002195045468798895,0.0017540013155010747,17640,2945,0,639,8317,6378,9122
2020-06-11,navarra,Navarra,John Hopkins University,5303,490,0,136,4,0,0,0,-150.0,154.0,0,908,3905,2048,0.0007548594074353598,0.0,,0.0,-0.14177693761814747,0.04105571847507328,0.0,5299,490,0,136,1058,3751,2048
2020-06-11,melilla,Melilla,John Hopkins University,122,2,0,3,0,0,0,0,-1.0,1.0,0,-5,125,44,0.0,0.0,,0.0,,0.008064516129032251,0.0,122,2,0,3,-4,124,44
2020-06-11,canarias,Canarias,John Hopkins University,2372,151,0,179,0,0,0,0,-13.0,13.0,1,684,1537,944,0.0,0.0,,0.0,-0.0186513629842181,0.00853018372703418,0.0010604453870626251,2372,151,0,179,697,1524,943
2020-06-11,baleares,Baleares,John Hopkins University,2142,209,0,169,5,0,0,1,-5.0,10.0,2,400,1533,1144,0.0023397285914834587,0.0,,0.005952380952380931,-0.012345679012345734,0.006565988181221227,0.0017513134851139256,2137,209,0,168,405,1523,1142
2020-06-11,murcia,Murcia,John Hopkins University,1626,148,0,112,2,0,0,0,-94.0,96.0,1,-702,2180,680,0.0012315270935960854,0.0,,0.0,,0.04606525911708248,0.0014727540500736325,1624,148,0,112,-608,2084,679
2020-06-11,cataluna,Cataluña,John Hopkins University,59423,5587,0,2969,125,0,0,0,94.0,31.0,0,27633,26203,29497,0.0021079968970285634,0.0,,0.0,0.0034133410799230823,0.0011844719547609017,0.0,59298,5587,0,2969,27539,26172,29497
2020-06-11,c_valenciana,C. Valenciana,John Hopkins University,11381,1332,0,730,20,0,0,3,-43.0,63.0,5,79,9970,5747,0.0017604084147522236,0.0,,0.004126547455295837,-0.35245901639344257,0.00635914000201887,0.0008707767328457461,11361,1332,0,727,122,9907,5742
2020-06-11,asturias,Asturias,John Hopkins University,2431,314,0,121,0,0,0,0,-2.0,2.0,0,1054,1063,1089,0.0,0.0,,0.0,-0.0018939393939394478,0.0018850141376061114,0.0,2431,314,0,121,1056,1061,1089
2020-06-11,galicia,Galicia,John Hopkins University,9154,609,0,334,1,0,0,0,-48.0,49.0,4,-659,9204,2943,0.00010925379656945289,0.0,,0.0,,0.005352266521026827,0.0013610071452874184,9153,609,0,334,-611,9155,2939
2020-06-11,madrid,Madrid,John Hopkins University,70051,8691,0,3617,156,0,0,7,118.0,38.0,75,20624,40736,42497,0.002231919307532637,0.0,,0.0019390581717451116,0.005754413342436315,0.0009337068160597539,0.0017679505916741167,69895,8691,0,3610,20506,40698,42422
2020-06-11,andalucia,Andalucía,John Hopkins University,12804,1404,0,766,4,0,0,2,-56.0,60.0,14,729,10671,6210,0.00031249999999993783,0.0,,0.002617801047120505,-0.07133757961783438,0.005654509471303415,0.002259522272433756,12800,1404,0,764,785,10611,6196
2020-06-11,castilla_y_leon,Castilla y León,John Hopkins University,19254,1928,0,561,32,0,0,6,32.0,,1,8610,8716,8735,0.0016647591301632847,0.0,,0.0108108108108107,0.0037304733038003857,,0.00011449507671179582,19222,1928,0,555,8578,8716,8734
2020-06-11,ceuta,Ceuta,John Hopkins University,163,4,0,4,0,0,0,0,,,0,-4,163,11,0.0,0.0,,0.0,,,0.0,163,4,0,4,-4,163,11
2020-06-11,aragon,Aragón,John Hopkins University,5812,826,0,256,6,0,0,1,-39.0,45.0,8,1214,3772,2442,0.0010334137099552443,0.0,,0.0039215686274509665,-0.031125299281723917,0.012074054199087803,0.0032867707477404196,5806,826,0,255,1253,3727,2434
2020-06-11,pais_vasco,País Vasco,John Hopkins University,13595,1424,0,578,7,0,0,0,-125.0,132.0,8,-3989,16160,7032,0.0005151604356785633,0.0,,0.0,,0.00823558772148747,0.001138952164009055,13588,1424,0,578,-3864,16028,7024
2020-06-11,la_rioja,La Rioja,John Hopkins University,4063,362,0,91,0,0,0,0,-59.0,59.0,5,594,3107,1504,0.0,0.0,,0.0,-0.09035222052067382,0.019356955380577467,0.0033355570380253496,4063,362,0,91,653,3048,1499
2020-06-11,extremadura,Extremadura,John Hopkins University,2983,508,0,110,1,0,0,0,-15.0,16.0,0,-177,2652,1780,0.0003353454057679617,0.0,,0.0,,0.006069802731411222,0.0,2982,508,0,110,-162,2636,1780
2020-06-11,cantabria,Cantabria,John Hopkins University,2327,202,0,79,3,0,0,0,-11.0,14.0,0,-162,2287,1036,0.001290877796901846,0.0,,0.0,,0.006159260888693341,0.0,2324,202,0,79,-151,2273,1036
2020-06-12,castilla-la_mancha,Castilla-La Mancha,John Hopkins University,17740,2945,0,639,38,0,0,0,24.0,14.0,16,8403,6392,9138,0.0021466500960343193,0.0,,0.0,0.0028643036161832836,0.002195045468798895,0.0017540013155010747,17702,2945,0,639,8379,6378,9122
2020-06-12,navarra,Navarra,John Hopkins University,5308,490,0,136,5,0,0,0,-149.0,154.0,0,913,3905,2048,0.0009428625306431293,0.0,,0.0,-0.14030131826741998,0.04105571847507328,0.0,5303,490,0,136,1062,3751,2048
2020-06-12,melilla,Melilla,John Hopkins University,122,2,0,3,0,0,0,0,-1.0,1.0,0,-5,125,44,0.0,0.0,,0.0,,0.008064516129032251,0.0,122,2,0,3,-4,124,44
2020-06-12,canarias,Canarias,John Hopkins University,2374,151,0,179,3,0,0,0,-10.0,13.0,1,686,1537,944,0.001265288907633888,0.0,,0.0,-0.014367816091954033,0.00853018372703418,0.0010604453870626251,2371,151,0,179,696,1524,943
2020-06-12,baleares,Baleares,John Hopkins University,2146,209,0,169,4,0,0,1,-6.0,10.0,2,404,1533,1144,0.0018674136321195078,0.0,,0.005952380952380931,-0.014634146341463428,0.006565988181221227,0.0017513134851139256,2142,209,0,168,410,1523,1142
2020-06-12,murcia,Murcia,John Hopkins University,1628,148,0,112,2,0,0,0,-94.0,96.0,1,-700,2180,680,0.0012300123001229846,0.0,,0.0,,0.04606525911708248,0.0014727540500736325,1626,148,0,112,-606,2084,679
2020-06-12,cataluna,Cataluña,John Hopkins University,59593,5587,0,2969,170,0,0,0,139.0,31.0,0,27803,26203,29497,0.002860845127307554,0.0,,0.0,0.005024580682475355,0.0011844719547609017,0.0,59423,5587,0,2969,27664,26172,29497
2020-06-12,c_valenciana,C. Valenciana,John Hopkins University,11389,1332,0,730,8,0,0,3,-55.0,63.0,5,87,9970,5747,0.0007029259291801981,0.0,,0.004126547455295837,-0.38732394366197187,0.00635914000201887,0.0008707767328457461,11381,1332,0,727,142,9907,5742
2020-06-12,asturias,Asturias,John Hopkins University,2435,314,0,121,4,0,0,0,2.0,2.0,0,1058,1063,1089,0.0016454134101193674,0.0,,0.0,0.0018939393939394478,0.0018850141376061114,0.0,2431,314,0,121,1056,1061,1089
2020-06-12,galicia,Galicia,John Hopkins University,9157,609,0,334,3,0,0,0,-46.0,49.0,4,-656,9204,2943,0.00032772558444404964,0.0,,0.0,,0.005352266521026827,0.0013610071452874184,9154,609,0,334,-610,9155,2939
2020-06-12,madrid,Madrid,John Hopkins University,70231,8691,0,3617,180,0,0,7,142.0,38.0,75,20804,40736,42497,0.00256955646600332,0.0,,0.0019390581717451116,0.006872519601200278,0.0009337068160597539,0.0017679505916741167,70051,8691,0,3610,20662,40698,42422
2020-06-12,andalucia,Andalucía,John Hopkins University,12814,1404,0,766,10,0,0,2,-50.0,60.0,14,739,10671,6210,0.0007810059356450072,0.0,,0.002617801047120505,-0.0633713561470215,0.005654509471303415,0.002259522272433756,12804,1404,0,764,789,10611,6196
2020-06-12,castilla_y_leon,Castilla y León,John Hopkins University,19296,1928,0,561,42,0,0,6,42.0,,1,8652,8716,8735,0.0021813649111872557,0.0,,0.0108108108108107,0.004878048780487809,,0.00011449507671179582,19254,1928,0,555,8610,8716,8734
2020-06-12,ceuta,Ceuta,John Hopkins University,163,4,0,4,0,0,0,0,,,0,-4,163,11,0.0,0.0,,0.0,,,0.0,163,4,0,4,-4,163,11
2020-06-12,aragon,Aragón,John Hopkins University,5833,826,0,256,21,0,0,1,-24.0,45.0,8,1235,3772,2442,0.003613214039917434,0.0,,0.0039215686274509665,-0.019062748212867353,0.012074054199087803,0.0032867707477404196,5812,826,0,255,1259,3727,2434
2020-06-12,pais_vasco,País Vasco,John Hopkins University,13603,1424,0,578,8,0,0,0,-124.0,132.0,8,-3981,16160,7032,0.0005884516366310155,0.0,,0.0,,0.00823558772148747,0.001138952164009055,13595,1424,0,578,-3857,16028,7024
2020-06-12,la_rioja,La Rioja,John Hopkins University,4066,362,0,91,3,0,0,0,-56.0,59.0,5,597,3107,1504,0.0007383706620722741,0.0,,0.0,-0.08575803981623276,0.019356955380577467,0.0033355570380253496,4063,362,0,91,653,3048,1499
2020-06-12,extremadura,Extremadura,John Hopkins University,2984,508,0,110,1,0,0,0,-15.0,16.0,0,-176,2652,1780,0.0003352329869259485,0.0,,0.0,,0.006069802731411222,0.0,2983,508,0,110,-161,2636,1780
2020-06-12,cantabria,Cantabria,John Hopkins University,2327,202,0,79,0,0,0,0,-14.0,14.0,0,-162,2287,1036,0.0,0.0,,0.0,,0.006159260888693341,0.0,2327,202,0,79,-148,2273,1036
2020-06-13,castilla-la_mancha,Castilla-La Mancha,John Hopkins University,17776,2945,0,639,36,0,0,0,22.0,14.0,16,8439,6392,9138,0.0020293122886132497,0.0,,0.0,0.0026137578709755083,0.002195045468798895,0.0017540013155010747,17740,2945,0,639,8417,6378,9122
2020-06-13,navarra,Navarra,John Hopkins University,5311,490,0,136,3,0,0,0,-151.0,154.0,0,916,3905,2048,0.0005651846269780769,0.0,,0.0,-0.14151827553889407,0.04105571847507328,0.0,5308,490,0,136,1067,3751,2048
2020-06-13,melilla,Melilla,John Hopkins University,123,2,0,3,1,0,0,0,,1.0,0,-4,125,44,0.008196721311475308,0.0,,0.0,,0.008064516129032251,0.0,122,2,0,3,-4,124,44
2020-06-13,canarias,Canarias,John Hopkins University,2377,151,0,179,3,0,0,0,-10.0,13.0,1,689,1537,944,0.0012636899747262564,0.0,,0.0,-0.014306151645207432,0.00853018372703418,0.0010604453870626251,2374,151,0,179,699,1524,943
2020-06-13,baleares,Baleares,John Hopkins University,2152,209,0,169,6,0,0,1,-4.0,10.0,2,410,1533,1144,0.002795899347623587,0.0,,0.005952380952380931,-0.009661835748792313,0.006565988181221227,0.0017513134851139256,2146,209,0,168,414,1523,1142
2020-06-13,murcia,Murcia,John Hopkins University,1628,148,0,112,0,0,0,0,-96.0,96.0,1,-700,2180,680,0.0,0.0,,0.0,,0.04606525911708248,0.0014727540500736325,1628,148,0,112,-604,2084,679
2020-06-13,cataluna,Cataluña,John Hopkins University,59706,5587,0,2969,113,0,0,0,82.0,31.0,0,27916,26203,29497,0.0018961958619301278,0.0,,0.0,0.002946037220665332,0.0011844719547609017,0.0,59593,5587,0,2969,27834,26172,29497
2020-06-13,c_valenciana,C. Valenciana,John Hopkins University,11393,1332,0,730,4,0,0,3,-59.0,63.0,5,91,9970,5747,0.0003512160856966595,0.0,,0.004126547455295837,-0.3933333333333333,0.00635914000201887,0.0008707767328457461,11389,1332,0,727,150,9907,5742
2020-06-13,asturias,Asturias,John Hopkins University,2437,314,0,121,2,0,0,0,,2.0,0,1060,1063,1089,0.000821355236139576,0.0,,0.0,,0.0018850141376061114,0.0,2435,314,0,121,1060,1061,1089
2020-06-13,galicia,Galicia,John Hopkins University,9158,609,0,334,1,0,0,0,-48.0,49.0,4,-655,9204,2943,0.00010920607185749276,0.0,,0.0,,0.005352266521026827,0.0013610071452874184,9157,609,0,334,-607,9155,2939
2020-06-13,madrid,Madrid,John Hopkins University,70398,8691,0,3617,167,0,0,7,129.0,38.0,75,20971,40736,42497,0.002377867323546612,0.0,,0.0019390581717451116,0.006189425199117249,0.0009337068160597539,0.0017679505916741167,70231,8691,0,3610,20842,40698,42422
2020-06-13,andalucia,Andalucía,John Hopkins University,12823,1404,0,766,9,0,0,2,-51.0,60.0,14,748,10671,6210,0.0007023567972530564,0.0,,0.002617801047120505,-0.06382978723404253,0.005654509471303415,0.002259522272433756,12814,1404,0,764,799,10611,6196
2020-06-13,castilla_y_leon,Castilla y León,John Hopkins University,19324,1928,0,561,28,0,0,6,28.0,,1,8680,8716,8735,0.0014510779436152088,0.0,,0.0108108108108107,0.003236245954692629,,0.00011449507671179582,19296,1928,0,555,8652,8716,8734
2020-06-13,ceuta,Ceuta,John Hopkins University,163,4,0,4,0,0,0,0,,,0,-4,163,11,0.0,0.0,,0.0,,,0.0,163,4,0,4,-4,163,11
2020-06-13,aragon,Aragón,John Hopkins University,5836,826,0,256,3,0,0,1,-42.0,45.0,8,1238,3772,2442,0.000514315103720131,0.0,,0.0039215686274509665,-0.03281250000000002,0.012074054199087803,0.0032867707477404196,5833,826,0,255,1280,3727,2434
2020-06-13,pais_vasco,País Vasco,John Hopkins University,13616,1424,0,578,13,0,0,0,-119.0,132.0,8,-3968,16160,7032,0.0009556715430418805,0.0,,0.0,,0.00823558772148747,0.001138952164009055,13603,1424,0,578,-3849,16028,7024
2020-06-13,la_rioja,La Rioja,John Hopkins University,4067,362,0,91,1,0,0,0,-58.0,59.0,5,598,3107,1504,0.00024594195769789273,0.0,,0.0,-0.08841463414634143,0.019356955380577467,0.0033355570380253496,4066,362,0,91,656,3048,1499
2020-06-13,extremadura,Extremadura,John Hopkins University,2985,508,0,110,1,0,0,0,-15.0,16.0,0,-175,2652,1780,0.00033512064343166337,0.0,,0.0,,0.006069802731411222,0.0,2984,508,0,110,-160,2636,1780
2020-06-13,cantabria,Cantabria,John Hopkins University,2332,202,0,79,5,0,0,0,-9.0,14.0,0,-157,2287,1036,0.0021486892995272733,0.0,,0.0,,0.006159260888693341,0.0,2327,202,0,79,-148,2273,1036
2020-06-14,castilla-la_mancha,Castilla-La Mancha,John Hopkins University,17803,2945,0,639,27,0,0,0,13.0,14.0,16,8466,6392,9138,0.001518901890189106,0.0,,0.0,0.0015379155329469096,0.002195045468798895,0.0017540013155010747,17776,2945,0,639,8453,6378,9122
2020-06-14,navarra,Navarra,John Hopkins University,5311,490,0,136,0,0,0,0,-154.0,154.0,0,916,3905,2048,0.0,0.0,,0.0,-0.14392523364485976,0.04105571847507328,0.0,5311,490,0,136,1070,3751,2048
2020-06-14,melilla,Melilla,John Hopkins University,124,2,0,3,1,0,0,0,,1.0,0,-3,125,44,0.008130081300812941,0.0,,0.0,,0.008064516129032251,0.0,123,2,0,3,-3,124,44
2020-06-14,canarias,Canarias,John Hopkins University,2378,151,0,179,1,0,0,0,-12.0,13.0,1,690,1537,944,0.00042069835927649457,0.0,,0.0,-0.017094017094017144,0.00853018372703418,0.0010604453870626251,2377,151,0,179,702,1524,943
2020-06-14,baleares,Baleares,John Hopkins University,2154,209,0,169,2,0,0,1,-8.0,10.0,2,412,1533,1144,0.0009293680297397522,0.0,,0.005952380952380931,-0.01904761904761909,0.006565988181221227,0.0017513134851139256,2152,209,0,168,420,1523,1142
2020-06-14,murcia,Murcia,John Hopkins University,1629,148,0,112,1,0,0,0,-95.0,96.0,1,-699,2180,680,0.0006142506142505777,0.0,,0.0,,0.04606525911708248,0.0014727540500736325,1628,148,0,112,-604,2084,679
2020-06-14,cataluna,Cataluña,John Hopkins University,59820,5587,0,2969,114,0,0,0,83.0,31.0,0,28030,26203,29497,0.001909355843633831,0.0,,0.0,0.00296990732457858,0.0011844719547609017,0.0,59706,5587,0,2969,27947,26172,29497
2020-06-14,c_valenciana,C. Valenciana,John Hopkins University,11404,1332,0,730,11,0,0,3,-52.0,63.0,5,102,9970,5747,0.0009655051347319255,0.0,,0.004126547455295837,-0.33766233766233766,0.00635914000201887,0.0008707767328457461,11393,1332,0,727,154,9907,5742
2020-06-14,asturias,Asturias,John Hopkins University,2437,314,0,121,0,0,0,0,-2.0,2.0,0,1060,1063,1089,0.0,0.0,,0.0,-0.0018832391713747842,0.0018850141376061114,0.0,2437,314,0,121,1062,1061,1089
2020-06-14,galicia,Galicia,John Hopkins University,9159,609,0,334,1,0,0,0,-48.0,49.0,4,-654,9204,2943,0.00010919414719379184,0.0,,0.0,,0.005352266521026827,0.0013610071452874184,9158,609,0,334,-606,9155,2939
2020-06-14,madrid,Madrid,John Hopkins University,70521,8691,0,3617,123,0,0,7,85.0,38.0,75,21094,40736,42497,0.001747208727520766,0.0,,0.0019390581717451116,0.004045885096863211,0.0009337068160597539,0.0017679505916741167,70398,8691,0,3610,21009,40698,42422
2020-06-14,andalucia,Andalucía,John Hopkins University,12827,1404,0,766,4,0,0,2,-56.0,60.0,14,752,10671,6210,0.00031193948374008684,0.0,,0.002617801047120505,-0.06930693069306926,0.005654509471303415,0.002259522272433756,12823,1404,0,764,808,10611,6196
2020-06-14,castilla_y_leon,Castilla y León,John Hopkins University,19343,1928,0,561,19,0,0,6,19.0,,1,8699,8716,8735,0.0009832332850341352,0.0,,0.0108108108108107,0.0021889400921659696,,0.00011449507671179582,19324,1928,0,555,8680,8716,8734
2020-06-14,ceuta,Ceuta,John Hopkins University,163,4,0,4,0,0,0,0,,,0,-4,163,11,0.0,0.0,,0.0,,,0.0,163,4,0,4,-4,163,11
2020-06-14,aragon,Aragón,John Hopkins University,5840,826,0,256,4,0,0,1,-41.0,45.0,8,1242,3772,2442,0.0006854009595613775,0.0,,0.0039215686274509665,-0.031956352299298496,0.012074054199087803,0.0032867707477404196,5836,826,0,255,1283,3727,2434
2020-06-14,pais_vasco,País Vasco,John Hopkins University,13626,1424,0,578,10,0,0,0,-122.0,132.0,8,-3958,16160,7032,0.0007344300822562655,0.0,,0.0,,0.00823558772148747,0.001138952164009055,13616,1424,0,578,-3836,16028,7024
2020-06-14,la_rioja,La Rioja,John Hopkins University,4068,362,0,91,1,0,0,0,-58.0,59.0,5,599,3107,1504,0.00024588148512427743,0.0,,0.0,-0.0882800608828006,0.019356955380577467,0.0033355570380253496,4067,362,0,91,657,3048,1499
2020-06-14,extremadura,Extremadura,John Hopkins University,2987,508,0,110,2,0,0,0,-14.0,16.0,0,-173,2652,1780,0.0006700167504187782,0.0,,0.0,,0.006069802731411222,0.0,2985,508,0,110,-159,2636,1780
2020-06-14,cantabria,Cantabria,John Hopkins University,2334,202,0,79,2,0,0,0,-12.0,14.0,0,-155,2287,1036,0.0008576329331047017,0.0,,0.0,,0.006159260888693341,0.0,2332,202,0,79,-143,2273,1036
2020-06-15,castilla-la_mancha,Castilla-La Mancha,John Hopkins University,17811,2945,0,639,8,0,0,0,-6.0,14.0,16,8474,6392,9138,0.0004493624669998919,0.0,,0.0,-0.0007075471698113622,0.002195045468798895,0.0017540013155010747,17803,2945,0,639,8480,6378,9122
2020-06-15,navarra,Navarra,John Hopkins University,5311,490,0,136,0,0,0,0,-154.0,154.0,0,916,3905,2048,0.0,0.0,,0.0,-0.14392523364485976,0.04105571847507328,0.0,5311,490,0,136,1070,3751,2048
2020-06-15,melilla,Melilla,John Hopkins University,124,2,0,3,0,0,0,0,-1.0,1.0,0,-3,125,44,0.0,0.0,,0.0,,0.008064516129032251,0.0,124,2,0,3,-2,124,44
2020-06-15,canarias,Canarias,John Hopkins University,2378,151,0,179,0,0,0,0,-13.0,13.0,1,690,1537,944,0.0,0.0,,0.0,-0.01849217638691325,0.00853018372703418,0.0010604453870626251,2378,151,0,179,703,1524,943
2020-06-15,baleares,Baleares,John Hopkins University,2157,209,0,169,3,0,0,1,-7.0,10.0,2,415,1533,1144,0.0013927576601671099,0.0,,0.005952380952380931,-0.016587677725118488,0.006565988181221227,0.0017513134851139256,2154,209,0,168,422,1523,1142
2020-06-15,murcia,Murcia,John Hopkins University,1629,148,0,112,0,0,0,0,-96.0,96.0,1,-699,2180,680,0.0,0.0,,0.0,,0.04606525911708248,0.0014727540500736325,1629,148,0,112,-603,2084,679
2020-06-15,cataluna,Cataluña,John Hopkins University,59897,5587,0,2969,77,0,0,0,46.0,31.0,0,28107,26203,29497,0.0012871949180874864,0.0,,0.0,0.001639285841559479,0.0011844719547609017,0.0,59820,5587,0,2969,28061,26172,29497
2020-06-15,c_valenciana,C. Valenciana,John Hopkins University,11418,1332,0,730,14,0,0,3,-49.0,63.0,5,116,9970,5747,0.0012276394247632272,0.0,,0.004126547455295837,-0.296969696969697,0.00635914000201887,0.0008707767328457461,11404,1332,0,727,165,9907,5742
2020-06-15,asturias,Asturias,John Hopkins University,2437,314,0,121,0,0,0,0,-2.0,2.0,0,1060,1063,1089,0.0,0.0,,0.0,-0.0018832391713747842,0.0018850141376061114,0.0,2437,314,0,121,1062,1061,1089
2020-06-15,galicia,Galicia,John Hopkins University,9160,609,0,334,1,0,0,0,-48.0,49.0,4,-653,9204,2943,0.00010918222513378595,0.0,,0.0,,0.005352266521026827,0.0013610071452874184,9159,609,0,334,-605,9155,2939
2020-06-15,madrid,Madrid,John Hopkins University,70570,8691,0,3617,49,0,0,7,11.0,38.0,75,21143,40736,42497,0.0006948284908041558,0.0,,0.0019390581717451116,0.0005205375733485784,0.0009337068160597539,0.0017679505916741167,70521,8691,0,3610,21132,40698,42422
2020-06-15,andalucia,Andalucía,John Hopkins University,12830,1404,0,766,3,0,0,2,-57.0,60.0,14,755,10671,6210,0.00023388165588222876,0.0,,0.002617801047120505,-0.07019704433497542,0.005654509471303415,0.002259522272433756,12827,1404,0,764,812,10611,6196
2020-06-15,castilla_y_leon,Castilla y León,John Hopkins University,19353,1928,0,561,10,0,0,6,10.0,,1,8709,8716,8735,0.0005169828878663907,0.0,,0.0108108108108107,0.0011495574203932435,,0.00011449507671179582,19343,1928,0,555,8699,8716,8734
2020-06-15,ceuta,Ceuta,John Hopkins University,163,4,0,4,0,0,0,0,,,0,-4,163,11,0.0,0.0,,0.0,,,0.0,163,4,0,4,-4,163,11
2020-06-15,aragon,Aragón,John Hopkins University,5842,826,0,256,2,0,0,1,-43.0,45.0,8,1244,3772,2442,0.000342465753424559,0.0,,0.0039215686274509665,-0.033411033411033464,0.012074054199087803,0.0032867707477404196,5840,826,0,255,1287,3727,2434
2020-06-15,pais_vasco,País Vasco,John Hopkins University,13638,1424,0,578,12,0,0,0,-120.0,132.0,8,-3946,16160,7032,0.0008806693086746975,0.0,,0.0,,0.00823558772148747,0.001138952164009055,13626,1424,0,578,-3826,16028,7024
2020-06-15,la_rioja,La Rioja,John Hopkins University,4069,362,0,91,1,0,0,0,-58.0,59.0,5,600,3107,1504,0.0002458210422813245,0.0,,0.0,-0.08814589665653494,0.019356955380577467,0.0033355570380253496,4068,362,0,91,658,3048,1499
2020-06-15,extremadura,Extremadura,John Hopkins University,2988,508,0,110,1,0,0,0,-15.0,16.0,0,-172,2652,1780,0.0003347840642784483,0.0,,0.0,,0.006069802731411222,0.0,2987,508,0,110,-157,2636,1780
2020-06-15,cantabria,Cantabria,John Hopkins University,2334,202,0,79,0,0,0,0,-14.0,14.0,0,-155,2287,1036,0.0,0.0,,0.0,,0.006159260888693341,0.0,2334,202,0,79,-141,2273,1036
2020-06-16,castilla-la_mancha,Castilla-La Mancha,John Hopkins University,17828,2945,0,639,17,0,0,0,3.0,14.0,16,8491,6392,9138,0.0009544663410252507,0.0,,0.0,0.0003534401508011875,0.002195045468798895,0.0017540013155010747,17811,2945,0,639,8488,6378,9122
2020-06-16,navarra,Navarra,John Hopkins University,5312,490,0,136,1,0,0,0,-153.0,154.0,0,917,3905,2048,0.00018828845791762916,0.0,,0.0,-0.14299065420560753,0.04105571847507328,0.0,5311,490,0,136,1070,3751,2048
2020-06-16,melilla,Melilla,John Hopkins University,124,2,0,3,0,0,0,0,-1.0,1.0,0,-3,125,44,0.0,0.0,,0.0,,0.008064516129032251,0.0,124,2,0,3,-2,124,44
2020-06-16,canarias,Canarias,John Hopkins University,2382,151,0,179,4,0,0,0,-9.0,13.0,1,694,1537,944,0.001682085786375076,0.0,,0.0,-0.012802275960170695,0.00853018372703418,0.0010604453870626251,2378,151,0,179,703,1524,943
2020-06-16,baleares,Baleares,John Hopkins University,2163,209,0,169,6,0,0,1,-4.0,10.0,2,421,1533,1144,0.0027816411682892728,0.0,,0.005952380952380931,-0.009411764705882342,0.006565988181221227,0.0017513134851139256,2157,209,0,168,425,1523,1142
2020-06-16,murcia,Murcia,John Hopkins University,1629,148,0,112,0,0,0,0,-96.0,96.0,1,-699,2180,680,0.0,0.0,,0.0,,0.04606525911708248,0.0014727540500736325,1629,148,0,112,-603,2084,679
2020-06-16,cataluna,Cataluña,John Hopkins University,59944,5587,0,2969,47,0,0,0,16.0,31.0,0,28154,26203,29497,0.0007846803679649739,0.0,,0.0,0.0005686260572890234,0.0011844719547609017,0.0,59897,5587,0,2969,28138,26172,29497
2020-06-16,c_valenciana,C. Valenciana,John Hopkins University,11421,1332,0,730,3,0,0,3,-60.0,63.0,5,119,9970,5747,0.00026274303730944304,0.0,,0.004126547455295837,-0.33519553072625696,0.00635914000201887,0.0008707767328457461,11418,1332,0,727,179,9907,5742
2020-06-16,asturias,Asturias,John Hopkins University,2438,314,0,121,1,0,0,0,-1.0,2.0,0,1061,1063,1089,0.0004103405826836326,0.0,,0.0,-0.0009416195856873921,0.0018850141376061114,0.0,2437,314,0,121,1062,1061,1089
2020-06-16,galicia,Galicia,John Hopkins University,9161,609,0,334,1,0,0,0,-48.0,49.0,4,-652,9204,2943,0.00010917030567680897,0.0,,0.0,,0.005352266521026827,0.0013610071452874184,9160,609,0,334,-604,9155,2939
2020-06-16,madrid,Madrid,John Hopkins University,70675,8691,0,3617,105,0,0,7,67.0,38.0,75,21248,40736,42497,0.0014878843701289224,0.0,,0.0019390581717451116,0.003163212312921937,0.0009337068160597539,0.0017679505916741167,70570,8691,0,3610,21181,40698,42422
2020-06-16,andalucia,Andalucía,John Hopkins University,12835,1404,0,766,5,0,0,2,-55.0,60.0,14,760,10671,6210,0.000389711613406174,0.0,,0.002617801047120505,-0.06748466257668717,0.005654509471303415,0.002259522272433756,12830,1404,0,764,815,10611,6196
2020-06-16,castilla_y_leon,Castilla y León,John Hopkins University,19365,1928,0,561,12,0,0,6,12.0,,1,8721,8716,8735,0.0006200589055960215,0.0,,0.0108108108108107,0.0013778849466070664,,0.00011449507671179582,19353,1928,0,555,8709,8716,8734
2020-06-16,ceuta,Ceuta,John Hopkins University,163,4,0,4,0,0,0,0,,,0,-4,163,11,0.0,0.0,,0.0,,,0.0,163,4,0,4,-4,163,11
2020-06-16,aragon,Aragón,John Hopkins University,5845,826,0,256,3,0,0,1,-42.0,45.0,8,1247,3772,2442,0.000513522766175889,0.0,,0.0039215686274509665,-0.03258339798293253,0.012074054199087803,0.0032867707477404196,5842,826,0,255,1289,3727,2434
2020-06-16,pais_vasco,País Vasco,John Hopkins University,13648,1424,0,578,10,0,0,0,-122.0,132.0,8,-3936,16160,7032,0.0007332453438919639,0.0,,0.0,,0.00823558772148747,0.001138952164009055,13638,1424,0,578,-3814,16028,7024
2020-06-16,la_rioja,La Rioja,John Hopkins University,4069,362,0,91,0,0,0,0,-59.0,59.0,5,600,3107,1504,0.0,0.0,,0.0,-0.08952959028831564,0.019356955380577467,0.0033355570380253496,4069,362,0,91,659,3048,1499
2020-06-16,extremadura,Extremadura,John Hopkins University,2990,508,0,110,2,0,0,0,-14.0,16.0,0,-170,2652,1780,0.0006693440428380271,0.0,,0.0,,0.006069802731411222,0.0,2988,508,0,110,-156,2636,1780
2020-06-16,cantabria,Cantabria,John Hopkins University,2336,202,0,79,2,0,0,0,-12.0,14.0,0,-153,2287,1036,0.0008568980291345785,0.0,,0.0,,0.006159260888693341,0.0,2334,202,0,79,-141,2273,1036
2020-06-17,castilla-la_mancha,Castilla-La Mancha,John Hopkins University,17845,2945,0,639,17,0,0,0,3.0,14.0,16,8508,6392,9138,0.0009535562037243928,0.0,,0.0,0.00035273368606691946,0.002195045468798895,0.0017540013155010747,17828,2945,0,639,8505,6378,9122
2020-06-17,navarra,Navarra,John Hopkins University,5359,490,0,136,47,0,0,0,-107.0,154.0,0,964,3905,2048,0.008847891566265087,0.0,,0.0,-0.099906629318394,0.04105571847507328,0.0,5312,490,0,136,1071,3751,2048
2020-06-17,melilla,Melilla,John Hopkins University,124,2,0,3,0,0,0,0,-1.0,1.0,0,-3,125,44,0.0,0.0,,0.0,,0.008064516129032251,0.0,124,2,0,3,-2,124,44
2020-06-17,canarias,Canarias,John Hopkins University,2382,151,0,179,0,0,0,0,-13.0,13.0,1,694,1537,944,0.0,0.0,,0.0,-0.018387553041018356,0.00853018372703418,0.0010604453870626251,2382,151,0,179,707,1524,943
2020-06-17,baleares,Baleares,John Hopkins University,2165,209,0,169,2,0,0,1,-8.0,10.0,2,423,1533,1144,0.000924641701340656,0.0,,0.005952380952380931,-0.018561484918793503,0.006565988181221227,0.0017513134851139256,2163,209,0,168,431,1523,1142
2020-06-17,murcia,Murcia,John Hopkins University,1631,148,0,112,2,0,0,0,-94.0,96.0,1,-697,2180,680,0.0012277470841006721,0.0,,0.0,,0.04606525911708248,0.0014727540500736325,1629,148,0,112,-603,2084,679
2020-06-17,cataluna,Cataluña,John Hopkins University,60030,5587,0,2969,86,0,0,0,55.0,31.0,0,28240,26203,29497,0.0014346723608702483,0.0,,0.0,0.0019513925847081115,0.0011844719547609017,0.0,59944,5587,0,2969,28185,26172,29497
2020-06-17,c_valenciana,C. Valenciana,John Hopkins University,11431,1332,0,730,10,0,0,3,-53.0,63.0,5,129,9970,5747,0.0008755800717976658,0.0,,0.004126547455295837,-0.2912087912087912,0.00635914000201887,0.0008707767328457461,11421,1332,0,727,182,9907,5742
2020-06-17,asturias,Asturias,John Hopkins University,2438,314,0,121,0,0,0,0,-2.0,2.0,0,1061,1063,1089,0.0,0.0,,0.0,-0.0018814675446848783,0.0018850141376061114,0.0,2438,314,0,121,1063,1061,1089
2020-06-17,galicia,Galicia,John Hopkins University,9164,609,0,334,3,0,0,0,-46.0,49.0,4,-649,9204,2943,0.00032747516646658426,0.0,,0.0,,0.005352266521026827,0.0013610071452874184,9161,609,0,334,-603,9155,2939
2020-06-17,madrid,Madrid,John Hopkins University,70799,8691,0,3617,124,0,0,7,86.0,38.0,75,21372,40736,42497,0.001754510081358296,0.0,,0.0019390581717451116,0.004040214225312422,0.0009337068160597539,0.0017679505916741167,70675,8691,0,3610,21286,40698,42422
2020-06-17,andalucia,Andalucía,John Hopkins University,12839,1404,0,766,4,0,0,2,-56.0,60.0,14,764,10671,6210,0.00031164783794301876,0.0,,0.002617801047120505,-0.06829268292682922,0.005654509471303415,0.002259522272433756,12835,1404,0,764,820,10611,6196
2020-06-17,castilla_y_leon,Castilla y León,John Hopkins University,19407,1928,0,561,42,0,0,6,42.0,,1,8763,8716,8735,0.0021688613477923724,0.0,,0.0108108108108107,0.004815961472308228,,0.00011449507671179582,19365,1928,0,555,8721,8716,8734
2020-06-17,ceuta,Ceuta,John Hopkins University,163,4,0,4,0,0,0,0,,,0,-4,163,11,0.0,0.0,,0.0,,,0.0,163,4,0,4,-4,163,11
2020-06-17,aragon,Aragón,John Hopkins University,5850,826,0,256,5,0,0,1,-40.0,45.0,8,1252,3772,2442,0.0008554319931566301,0.0,,0.0039215686274509665,-0.03095975232198145,0.012074054199087803,0.0032867707477404196,5845,826,0,255,1292,3727,2434
2020-06-17,pais_vasco,País Vasco,John Hopkins University,13658,1424,0,578,10,0,0,0,-122.0,132.0,8,-3926,16160,7032,0.0007327080890973114,0.0,,0.0,,0.00823558772148747,0.001138952164009055,13648,1424,0,578,-3804,16028,7024
2020-06-17,la_rioja,La Rioja,John Hopkins University,4070,362,0,91,1,0,0,0,-58.0,59.0,5,601,3107,1504,0.0002457606291472736,0.0,,0.0,-0.08801213960546284,0.019356955380577467,0.0033355570380253496,4069,362,0,91,659,3048,1499
2020-06-17,extremadura,Extremadura,John Hopkins University,2992,508,0,110,2,0,0,0,-14.0,16.0,0,-168,2652,1780,0.0006688963210701449,0.0,,0.0,,0.006069802731411222,0.0,2990,508,0,110,-154,2636,1780
2020-06-17,cantabria,Cantabria,John Hopkins University,2338,202,0,79,2,0,0,0,-12.0,14.0,0,-151,2287,1036,0.0008561643835616195,0.0,,0.0,,0.006159260888693341,0.0,2336,202,0,79,-139,2273,1036
2020-06-18,castilla-la_mancha,Castilla-La Mancha,John Hopkins University,17894,2945,0,639,49,0,0,0,35.0,14.0,16,8557,6392,9138,0.002745867189688944,0.0,,0.0,0.0041070171321286875,0.002195045468798895,0.0017540013155010747,17845,2945,0,639,8522,6378,9122
2020-06-18,navarra,Navarra,John Hopkins University,5364,490,0,136,5,0,0,0,-149.0,154.0,0,969,3905,2048,0.0009330098899047456,0.0,,0.0,-0.13327370304114494,0.04105571847507328,0.0,5359,490,0,136,1118,3751,2048
2020-06-18,melilla,Melilla,John Hopkins University,124,2,0,3,0,0,0,0,-1.0,1.0,0,-3,125,44,0.0,0.0,,0.0,,0.008064516129032251,0.0,124,2,0,3,-2,124,44
2020-06-18,canarias,Canarias,John Hopkins University,2398,151,0,179,16,0,0,0,3.0,13.0,1,710,1537,944,0.0067170445004198776,0.0,,0.0,0.004243281471004279,0.00853018372703418,0.0010604453870626251,2382,151,0,179,707,1524,943
2020-06-18,baleares,Baleares,John Hopkins University,2167,209,0,169,2,0,0,1,-8.0,10.0,2,425,1533,1144,0.0009237875288683473,0.0,,0.005952380952380931,-0.018475750577367167,0.006565988181221227,0.0017513134851139256,2165,209,0,168,433,1523,1142
2020-06-18,murcia,Murcia,John Hopkins University,1631,148,0,112,0,0,0,0,-96.0,96.0,1,-697,2180,680,0.0,0.0,,0.0,,0.04606525911708248,0.0014727540500736325,1631,148,0,112,-601,2084,679
2020-06-18,cataluna,Cataluña,John Hopkins University,60340,5587,0,2969,310,0,0,0,279.0,31.0,0,28550,26203,29497,0.005164084624354581,0.0,,0.0,0.009868770117788639,0.0011844719547609017,0.0,60030,5587,0,2969,28271,26172,29497
2020-06-18,c_valenciana,C. Valenciana,John Hopkins University,11441,1332,0,730,10,0,0,3,-53.0,63.0,5,139,9970,5747,0.0008748141020034073,0.0,,0.004126547455295837,-0.27604166666666663,0.00635914000201887,0.0008707767328457461,11431,1332,0,727,192,9907,5742
2020-06-18,asturias,Asturias,John Hopkins University,2436,314,0,121,0,0,0,0,-2.0,2.0,0,1059,1063,1089,0.0,0.0,,0.0,-0.0018850141376060003,0.0018850141376061114,0.0,2436,314,0,121,1061,1061,1089
2020-06-18,galicia,Galicia,John Hopkins University,9164,609,0,334,0,0,0,0,-49.0,49.0,4,-649,9204,2943,0.0,0.0,,0.0,,0.005352266521026827,0.0013610071452874184,9164,609,0,334,-600,9155,2939
2020-06-18,madrid,Madrid,John Hopkins University,70934,8691,0,3617,135,0,0,7,97.0,38.0,75,21507,40736,42497,0.001906806593313437,0.0,,0.0019390581717451116,0.004530593180756659,0.0009337068160597539,0.0017679505916741167,70799,8691,0,3610,21410,40698,42422
2020-06-18,andalucia,Andalucía,John Hopkins University,12844,1404,0,766,5,0,0,2,-55.0,60.0,14,769,10671,6210,0.00038943842978422794,0.0,,0.002617801047120505,-0.066747572815534,0.005654509471303415,0.002259522272433756,12839,1404,0,764,824,10611,6196
2020-06-18,castilla_y_leon,Castilla y León,John Hopkins University,19434,1928,0,561,27,0,0,6,27.0,,1,8790,8716,8735,0.0013912505796878083,0.0,,0.0108108108108107,0.003081136597055778,,0.00011449507671179582,19407,1928,0,555,8763,8716,8734
2020-06-18,ceuta,Ceuta,John Hopkins University,163,4,0,4,0,0,0,0,,,0,-4,163,11,0.0,0.0,,0.0,,,0.0,163,4,0,4,-4,163,11
2020-06-18,aragon,Aragón,John Hopkins University,5855,826,0,256,5,0,0,1,-40.0,45.0,8,1257,3772,2442,0.0008547008547008517,0.0,,0.0039215686274509665,-0.030840400925212008,0.012074054199087803,0.0032867707477404196,5850,826,0,255,1297,3727,2434
2020-06-18,pais_vasco,País Vasco,John Hopkins University,13670,1424,0,578,12,0,0,0,-120.0,132.0,8,-3914,16160,7032,0.0008786059452334793,0.0,,0.0,,0.00823558772148747,0.001138952164009055,13658,1424,0,578,-3794,16028,7024
2020-06-18,la_rioja,La Rioja,John Hopkins University,4070,362,0,91,0,0,0,0,-59.0,59.0,5,601,3107,1504,0.0,0.0,,0.0,-0.08939393939393936,0.019356955380577467,0.0033355570380253496,4070,362,0,91,660,3048,1499
2020-06-18,extremadura,Extremadura,John Hopkins University,2999,508,0,110,7,0,0,0,-9.0,16.0,0,-161,2652,1780,0.0023395721925134616,0.0,,0.0,,0.006069802731411222,0.0,2992,508,0,110,-152,2636,1780
2020-06-18,cantabria,Cantabria,John Hopkins University,2341,202,0,79,3,0,0,0,-11.0,14.0,0,-148,2287,1036,0.0012831479897348341,0.0,,0.0,,0.006159260888693341,0.0,2338,202,0,79,-137,2273,1036
2020-06-19,castilla-la_mancha,Castilla-La Mancha,John Hopkins University,17894,3022,0,639,0,77,0,0,-91.0,14.0,16,8480,6392,9138,0.0,0.026146010186757218,,0.0,-0.010617197526542999,0.002195045468798895,0.0017540013155010747,17894,2945,0,639,8571,6378,9122
2020-06-19,navarra,Navarra,John Hopkins University,5370,528,0,136,6,38,0,0,-186.0,154.0,0,937,3905,2048,0.0011185682326622093,0.07755102040816331,,0.0,-0.16562778272484413,0.04105571847507328,0.0,5364,490,0,136,1123,3751,2048
2020-06-19,melilla,Melilla,John Hopkins University,124,2,0,3,0,0,0,0,-1.0,1.0,0,-3,125,44,0.0,0.0,,0.0,,0.008064516129032251,0.0,124,2,0,3,-2,124,44
2020-06-19,canarias,Canarias,John Hopkins University,2402,162,0,179,4,11,0,0,-20.0,13.0,1,703,1537,944,0.0016680567139282232,0.07284768211920523,,0.0,-0.02766251728907332,0.00853018372703418,0.0010604453870626251,2398,151,0,179,723,1524,943
2020-06-19,baleares,Baleares,John Hopkins University,2169,224,0,169,2,15,0,1,-23.0,10.0,2,412,1533,1144,0.0009229349330872605,0.0717703349282297,,0.005952380952380931,-0.05287356321839076,0.006565988181221227,0.0017513134851139256,2167,209,0,168,435,1523,1142
2020-06-19,murcia,Murcia,John Hopkins University,1638,148,0,112,7,0,0,0,-89.0,96.0,1,-690,2180,680,0.0042918454935623185,0.0,,0.0,,0.04606525911708248,0.0014727540500736325,1631,148,0,112,-601,2084,679
2020-06-19,cataluna,Cataluña,John Hopkins University,60450,5662,0,2969,110,75,0,0,4.0,31.0,0,28585,26203,29497,0.0018230029830959005,0.013424020046536533,,0.0,0.00013995311570624835,0.0011844719547609017,0.0,60340,5587,0,2969,28581,26172,29497
2020-06-19,c_valenciana,C. Valenciana,John Hopkins University,11451,1430,0,730,10,98,0,3,-151.0,63.0,5,51,9970,5747,0.0008740494712000668,0.07357357357357364,,0.004126547455295837,-0.7475247524752475,0.00635914000201887,0.0008707767328457461,11441,1332,0,727,202,9907,5742
2020-06-19,asturias,Asturias,John Hopkins University,2435,333,0,121,0,19,0,0,-21.0,2.0,0,1039,1063,1089,0.0,0.060509554140127486,,0.0,-0.019811320754717032,0.0018850141376061114,0.0,2435,314,0,121,1060,1061,1089
2020-06-19,galicia,Galicia,John Hopkins University,9169,619,0,334,5,10,0,0,-54.0,49.0,4,-654,9204,2943,0.000545613269314682,0.016420361247947435,,0.0,,0.005352266521026827,0.0013610071452874184,9164,609,0,334,-600,9155,2939
2020-06-19,madrid,Madrid,John Hopkins University,71007,8691,0,3617,73,0,0,7,35.0,38.0,75,21580,40736,42497,0.0010291256661121295,0.0,,0.0019390581717451116,0.0016245068461360201,0.0009337068160597539,0.0017679505916741167,70934,8691,0,3610,21545,40698,42422
2020-06-19,andalucia,Andalucía,John Hopkins University,12864,1426,0,766,20,22,0,2,-62.0,60.0,14,767,10671,6210,0.0015571473061350982,0.015669515669515688,,0.002617801047120505,-0.07478890229191792,0.005654509471303415,0.002259522272433756,12844,1404,0,764,829,10611,6196
2020-06-19,castilla_y_leon,Castilla y León,John Hopkins University,19466,2775,0,561,32,847,0,6,-815.0,,1,7975,8716,8735,0.001646598744468486,0.43931535269709543,,0.0108108108108107,-0.09271899886234358,,0.00011449507671179582,19434,1928,0,555,8790,8716,8734
2020-06-19,ceuta,Ceuta,John Hopkins University,163,4,0,4,0,0,0,0,,,0,-4,163,11,0.0,0.0,,0.0,,,0.0,163,4,0,4,-4,163,11
2020-06-19,aragon,Aragón,John Hopkins University,5880,911,0,256,25,85,0,1,-105.0,45.0,8,1197,3772,2442,0.004269854824936026,0.102905569007264,,0.0039215686274509665,-0.08064516129032262,0.012074054199087803,0.0032867707477404196,5855,826,0,255,1302,3727,2434
2020-06-19,pais_vasco,País Vasco,John Hopkins University,13679,1554,0,578,9,130,0,0,-253.0,132.0,8,-4035,16160,7032,0.0006583760058522792,0.09129213483146059,,0.0,,0.00823558772148747,0.001138952164009055,13670,1424,0,578,-3782,16028,7024
2020-06-19,la_rioja,La Rioja,John Hopkins University,4072,365,0,91,2,3,0,0,-60.0,59.0,5,600,3107,1504,0.0004914004914005066,0.008287292817679592,,0.0,-0.09090909090909094,0.019356955380577467,0.0033355570380253496,4070,362,0,91,660,3048,1499
2020-06-19,extremadura,Extremadura,John Hopkins University,3000,519,0,110,1,11,0,0,-26.0,16.0,0,-171,2652,1780,0.00033344448149374983,0.021653543307086576,,0.0,,0.006069802731411222,0.0,2999,508,0,110,-145,2636,1780
2020-06-19,cantabria,Cantabria,John Hopkins University,2342,216,0,79,1,14,0,0,-27.0,14.0,0,-161,2287,1036,0.0004271678769756093,0.06930693069306937,,0.0,,0.006159260888693341,0.0,2341,202,0,79,-134,2273,1036
2020-06-20,castilla-la_mancha,Castilla-La Mancha,John Hopkins University,17940,3022,0,639,46,0,0,0,32.0,14.0,16,8526,6392,9138,0.0025706940874035134,0.0,,0.0,0.0037673651989640344,0.002195045468798895,0.0017540013155010747,17894,3022,0,639,8494,6378,9122
2020-06-20,navarra,Navarra,John Hopkins University,5378,528,0,136,8,0,0,0,-146.0,154.0,0,945,3905,2048,0.0014897579143389184,0.0,,0.0,-0.13382218148487623,0.04105571847507328,0.0,5370,528,0,136,1091,3751,2048
2020-06-20,melilla,Melilla,John Hopkins University,124,2,0,3,0,0,0,0,-1.0,1.0,0,-3,125,44,0.0,0.0,,0.0,,0.008064516129032251,0.0,124,2,0,3,-2,124,44
2020-06-20,canarias,Canarias,John Hopkins University,2402,162,0,179,0,0,0,0,-13.0,13.0,1,703,1537,944,0.0,0.0,,0.0,-0.018156424581005637,0.00853018372703418,0.0010604453870626251,2402,162,0,179,716,1524,943
2020-06-20,baleares,Baleares,John Hopkins University,2174,224,0,169,5,0,0,1,-5.0,10.0,2,417,1533,1144,0.002305209774089434,0.0,,0.005952380952380931,-0.011848341232227444,0.006565988181221227,0.0017513134851139256,2169,224,0,168,422,1523,1142
2020-06-20,murcia,Murcia,John Hopkins University,1638,147,0,112,0,0,0,0,-96.0,96.0,1,-689,2180,680,0.0,0.0,,0.0,,0.04606525911708248,0.0014727540500736325,1638,147,0,112,-593,2084,679
2020-06-20,cataluna,Cataluña,John Hopkins University,60530,5666,0,2969,80,4,0,0,45.0,31.0,0,28661,26203,29497,0.001323407775020602,0.0007064641469445299,,0.0,0.00157254682694985,0.0011844719547609017,0.0,60450,5662,0,2969,28616,26172,29497
2020-06-20,c_valenciana,C. Valenciana,John Hopkins University,11476,1431,0,730,25,1,0,3,-39.0,63.0,5,75,9970,5747,0.0021832154396996817,0.0006993006993007977,,0.004126547455295837,-0.3421052631578947,0.00635914000201887,0.0008707767328457461,11451,1430,0,727,114,9907,5742
2020-06-20,asturias,Asturias,John Hopkins University,2435,333,0,121,0,0,0,0,-2.0,2.0,0,1039,1063,1089,0.0,0.0,,0.0,-0.0019212295869356355,0.0018850141376061114,0.0,2435,333,0,121,1041,1061,1089
2020-06-20,galicia,Galicia,John Hopkins University,9169,619,0,334,0,0,0,0,-49.0,49.0,4,-654,9204,2943,0.0,0.0,,0.0,,0.005352266521026827,0.0013610071452874184,9169,619,0,334,-605,9155,2939
2020-06-20,madrid,Madrid,John Hopkins University,71144,8416,0,3617,137,0,0,7,99.0,38.0,75,21992,40736,42497,0.0019293872435111048,0.0,,0.0019390581717451116,0.004521993331201735,0.0009337068160597539,0.0017679505916741167,71007,8416,0,3610,21893,40698,42422
2020-06-20,andalucia,Andalucía,John Hopkins University,12875,1426,0,766,11,0,0,2,-49.0,60.0,14,778,10671,6210,0.0008550995024876329,0.0,,0.002617801047120505,-0.059250302297460755,0.005654509471303415,0.002259522272433756,12864,1426,0,764,827,10611,6196
2020-06-20,castilla_y_leon,Castilla y León,John Hopkins University,19485,2776,0,561,19,1,0,6,18.0,,1,7993,8716,8735,0.0009760608240008128,0.0003603603603603567,,0.0108108108108107,0.0022570532915360264,,0.00011449507671179582,19466,2775,0,555,7975,8716,8734
2020-06-20,ceuta,Ceuta,John Hopkins University,163,4,0,4,0,0,0,0,,,0,-4,163,11,0.0,0.0,,0.0,,,0.0,163,4,0,4,-4,163,11
2020-06-20,aragon,Aragón,John Hopkins University,5898,911,0,256,18,0,0,1,-27.0,45.0,8,1215,3772,2442,0.003061224489795844,0.0,,0.0039215686274509665,-0.021739130434782594,0.012074054199087803,0.0032867707477404196,5880,911,0,255,1242,3727,2434
2020-06-20,pais_vasco,País Vasco,John Hopkins University,13693,1555,0,578,14,1,0,0,-119.0,132.0,8,-4022,16160,7032,0.001023466627677383,0.0006435006435006052,,0.0,,0.00823558772148747,0.001138952164009055,13679,1554,0,578,-3903,16028,7024
2020-06-20,la_rioja,La Rioja,John Hopkins University,4073,365,0,91,1,0,0,0,-58.0,59.0,5,601,3107,1504,0.000245579567780041,0.0,,0.0,-0.08801213960546284,0.019356955380577467,0.0033355570380253496,4072,365,0,91,659,3048,1499
2020-06-20,extremadura,Extremadura,John Hopkins University,3001,519,0,110,1,0,0,0,-15.0,16.0,0,-170,2652,1780,0.0003333333333332966,0.0,,0.0,,0.006069802731411222,0.0,3000,519,0,110,-155,2636,1780
2020-06-20,cantabria,Cantabria,John Hopkins University,2342,216,0,79,0,0,0,0,-14.0,14.0,0,-161,2287,1036,0.0,0.0,,0.0,,0.006159260888693341,0.0,2342,216,0,79,-147,2273,1036
2020-06-21,castilla-la_mancha,Castilla-La Mancha,John Hopkins University,17965,3022,0,639,25,0,0,0,11.0,14.0,16,8551,6392,9138,0.001393534002229746,0.0,,0.0,0.0012880562060890721,0.002195045468798895,0.0017540013155010747,17940,3022,0,639,8540,6378,9122
2020-06-21,navarra,Navarra,John Hopkins University,5381,528,0,136,3,0,0,0,-151.0,154.0,0,948,3905,2048,0.0005578281889178083,0.0,,0.0,-0.13739763421292084,0.04105571847507328,0.0,5378,528,0,136,1099,3751,2048
2020-06-21,melilla,Melilla,John Hopkins University,124,2,0,3,0,0,0,0,-1.0,1.0,0,-3,125,44,0.0,0.0,,0.0,,0.008064516129032251,0.0,124,2,0,3,-2,124,44
2020-06-21,canarias,Canarias,John Hopkins University,2414,162,0,179,12,0,0,0,-1.0,13.0,1,715,1537,944,0.004995836802664355,0.0,,0.0,-0.0013966480446927498,0.00853018372703418,0.0010604453870626251,2402,162,0,179,716,1524,943
2020-06-21,baleares,Baleares,John Hopkins University,2179,224,0,169,5,0,0,1,-5.0,10.0,2,422,1533,1144,0.0022999080036798514,0.0,,0.005952380952380931,-0.011709601873536313,0.006565988181221227,0.0017513134851139256,2174,224,0,168,427,1523,1142
2020-06-21,murcia,Murcia,John Hopkins University,1645,147,0,112,7,0,0,0,-89.0,96.0,1,-682,2180,680,0.004273504273504258,0.0,,0.0,,0.04606525911708248,0.0014727540500736325,1638,147,0,112,-593,2084,679
2020-06-21,cataluna,Cataluña,John Hopkins University,60645,5666,0,2969,115,0,0,0,84.0,31.0,0,28776,26203,29497,0.0018998843548654332,0.0,,0.0,0.0029276453366791078,0.0011844719547609017,0.0,60530,5666,0,2969,28692,26172,29497
2020-06-21,c_valenciana,C. Valenciana,John Hopkins University,11479,1431,0,730,3,0,0,3,-60.0,63.0,5,78,9970,5747,0.0002614151272219978,0.0,,0.004126547455295837,-0.4347826086956522,0.00635914000201887,0.0008707767328457461,11476,1431,0,727,138,9907,5742
2020-06-21,asturias,Asturias,John Hopkins University,2435,333,0,121,0,0,0,0,-2.0,2.0,0,1039,1063,1089,0.0,0.0,,0.0,-0.0019212295869356355,0.0018850141376061114,0.0,2435,333,0,121,1041,1061,1089
2020-06-21,galicia,Galicia,John Hopkins University,9174,619,0,334,7,0,0,0,-42.0,49.0,4,-649,9204,2943,0.0007636085960509575,0.0,,0.0,,0.005352266521026827,0.0013610071452874184,9167,619,0,334,-607,9155,2939
2020-06-21,madrid,Madrid,John Hopkins University,71223,8416,0,3617,79,0,0,7,41.0,38.0,75,22071,40736,42497,0.001110423928932791,0.0,,0.0019390581717451116,0.0018610985020426352,0.0009337068160597539,0.0017679505916741167,71144,8416,0,3610,22030,40698,42422
2020-06-21,andalucia,Andalucía,John Hopkins University,12884,1426,0,766,9,0,0,2,-51.0,60.0,14,787,10671,6210,0.0006990291262136683,0.0,,0.002617801047120505,-0.06085918854415273,0.005654509471303415,0.002259522272433756,12875,1426,0,764,838,10611,6196
2020-06-21,castilla_y_leon,Castilla y León,John Hopkins University,19499,2777,0,561,14,1,0,6,13.0,,1,8006,8716,8735,0.0007185014113419985,0.00036023054755052186,,0.0108108108108107,0.0016264231202300916,,0.00011449507671179582,19485,2776,0,555,7993,8716,8734
2020-06-21,ceuta,Ceuta,John Hopkins University,163,4,0,4,0,0,0,0,,,0,-4,163,11,0.0,0.0,,0.0,,,0.0,163,4,0,4,-4,163,11
2020-06-21,aragon,Aragón,John Hopkins University,5931,911,0,256,33,0,0,1,-12.0,45.0,8,1248,3772,2442,0.005595116988809767,0.0,,0.0039215686274509665,-0.00952380952380949,0.012074054199087803,0.0032867707477404196,5898,911,0,255,1260,3727,2434
2020-06-21,pais_vasco,País Vasco,John Hopkins University,13708,1555,0,578,15,0,0,0,-117.0,132.0,8,-4007,16160,7032,0.0010954502300446478,0.0,,0.0,,0.00823558772148747,0.001138952164009055,13693,1555,0,578,-3890,16028,7024
2020-06-21,la_rioja,La Rioja,John Hopkins University,4073,365,0,91,0,0,0,0,-59.0,59.0,5,601,3107,1504,0.0,0.0,,0.0,-0.08939393939393936,0.019356955380577467,0.0033355570380253496,4073,365,0,91,660,3048,1499
2020-06-21,extremadura,Extremadura,John Hopkins University,3006,519,0,110,5,0,0,0,-11.0,16.0,0,-165,2652,1780,0.001666111296234618,0.0,,0.0,,0.006069802731411222,0.0,3001,519,0,110,-154,2636,1780
2020-06-21,cantabria,Cantabria,John Hopkins University,2344,216,0,79,2,0,0,0,-12.0,14.0,0,-159,2287,1036,0.000853970964987294,0.0,,0.0,,0.006159260888693341,0.0,2342,216,0,79,-147,2273,1036
2020-06-22,castilla-la_mancha,Castilla-La Mancha,John Hopkins University,17987,3022,0,639,22,0,0,0,8.0,14.0,16,8573,6392,9138,0.0012246033954912416,0.0,,0.0,0.0009340338587273678,0.002195045468798895,0.0017540013155010747,17965,3022,0,639,8565,6378,9122
2020-06-22,navarra,Navarra,John Hopkins University,5402,528,0,136,21,0,0,0,-133.0,154.0,0,969,3905,2048,0.0039026203307934715,0.0,,0.0,-0.12068965517241381,0.04105571847507328,0.0,5381,528,0,136,1102,3751,2048
2020-06-22,melilla,Melilla,John Hopkins University,127,2,0,3,3,0,0,0,2.0,1.0,0,0,125,44,0.024193548387096753,0.0,,0.0,,0.008064516129032251,0.0,124,2,0,3,-2,124,44
2020-06-22,canarias,Canarias,John Hopkins University,2414,162,0,179,0,0,0,0,-13.0,13.0,1,715,1537,944,0.0,0.0,,0.0,-0.017857142857142905,0.00853018372703418,0.0010604453870626251,2414,162,0,179,728,1524,943
2020-06-22,baleares,Baleares,John Hopkins University,2187,224,0,169,8,0,0,1,-2.0,10.0,2,430,1533,1144,0.0036714089031666397,0.0,,0.005952380952380931,-0.00462962962962965,0.006565988181221227,0.0017513134851139256,2179,224,0,168,432,1523,1142
2020-06-22,murcia,Murcia,John Hopkins University,1653,147,0,112,8,0,0,0,-88.0,96.0,1,-674,2180,680,0.004863221884498392,0.0,,0.0,,0.04606525911708248,0.0014727540500736325,1645,147,0,112,-586,2084,679
2020-06-22,cataluna,Cataluña,John Hopkins University,60714,5666,0,2969,69,0,0,0,38.0,31.0,0,28845,26203,29497,0.0011377689834282112,0.0,,0.0,0.0013191238240706227,0.0011844719547609017,0.0,60645,5666,0,2969,28807,26172,29497
2020-06-22,c_valenciana,C. Valenciana,John Hopkins University,11486,1431,0,730,7,0,0,3,-56.0,63.0,5,85,9970,5747,0.0006098092168307367,0.0,,0.004126547455295837,-0.3971631205673759,0.00635914000201887,0.0008707767328457461,11479,1431,0,727,141,9907,5742
2020-06-22,asturias,Asturias,John Hopkins University,2435,333,0,121,0,0,0,0,-2.0,2.0,0,1039,1063,1089,0.0,0.0,,0.0,-0.0019212295869356355,0.0018850141376061114,0.0,2435,333,0,121,1041,1061,1089
2020-06-22,galicia,Galicia,John Hopkins University,9174,619,0,334,0,0,0,0,-49.0,49.0,4,-649,9204,2943,0.0,0.0,,0.0,,0.005352266521026827,0.0013610071452874184,9174,619,0,334,-600,9155,2939
2020-06-22,madrid,Madrid,John Hopkins University,71248,8416,0,3617,25,0,0,7,-13.0,38.0,75,22096,40736,42497,0.0003510102073769339,0.0,,0.0019390581717451116,-0.0005879958387986495,0.0009337068160597539,0.0017679505916741167,71223,8416,0,3610,22109,40698,42422
2020-06-22,andalucia,Andalucía,John Hopkins University,12892,1426,0,766,8,0,0,2,-52.0,60.0,14,795,10671,6210,0.0006209251785160852,0.0,,0.002617801047120505,-0.06139315230224318,0.005654509471303415,0.002259522272433756,12884,1426,0,764,847,10611,6196
2020-06-22,castilla_y_leon,Castilla y León,John Hopkins University,19516,2778,0,561,17,1,0,6,16.0,,1,8022,8716,8735,0.0008718395815170421,0.0003601008282319018,,0.0108108108108107,0.001998501124156782,,0.00011449507671179582,19499,2777,0,555,8006,8716,8734
2020-06-22,ceuta,Ceuta,John Hopkins University,163,4,0,4,0,0,0,0,,,0,-4,163,11,0.0,0.0,,0.0,,,0.0,163,4,0,4,-4,163,11
2020-06-22,aragon,Aragón,John Hopkins University,5964,911,0,256,33,0,0,1,-12.0,45.0,8,1281,3772,2442,0.005563985837127028,0.0,,0.0039215686274509665,-0.009280742459396807,0.012074054199087803,0.0032867707477404196,5931,911,0,255,1293,3727,2434
2020-06-22,pais_vasco,País Vasco,John Hopkins University,13715,1555,0,578,7,0,0,0,-125.0,132.0,8,-4000,16160,7032,0.0005106507149110762,0.0,,0.0,,0.00823558772148747,0.001138952164009055,13708,1555,0,578,-3875,16028,7024
2020-06-22,la_rioja,La Rioja,John Hopkins University,4073,365,0,91,0,0,0,0,-59.0,59.0,5,601,3107,1504,0.0,0.0,,0.0,-0.08939393939393936,0.019356955380577467,0.0033355570380253496,4073,365,0,91,660,3048,1499
2020-06-22,extremadura,Extremadura,John Hopkins University,3010,519,0,110,4,0,0,0,-12.0,16.0,0,-161,2652,1780,0.0013306719893546592,0.0,,0.0,,0.006069802731411222,0.0,3006,519,0,110,-149,2636,1780
2020-06-22,cantabria,Cantabria,John Hopkins University,2344,216,0,79,0,0,0,0,-14.0,14.0,0,-159,2287,1036,0.0,0.0,,0.0,,0.006159260888693341,0.0,2344,216,0,79,-145,2273,1036
2020-06-23,castilla-la_mancha,Castilla-La Mancha,John Hopkins University,17987,3022,0,639,0,0,0,0,-14.0,14.0,16,8573,6392,9138,0.0,0.0,,0.0,-0.001630371491789906,0.002195045468798895,0.0017540013155010747,17987,3022,0,639,8587,6378,9122
2020-06-23,navarra,Navarra,John Hopkins University,5415,528,0,136,13,0,0,0,-141.0,154.0,0,982,3905,2048,0.0024065161051463058,0.0,,0.0,-0.1255565449688335,0.04105571847507328,0.0,5402,528,0,136,1123,3751,2048
2020-06-23,melilla,Melilla,John Hopkins University,127,2,0,3,0,0,0,0,-1.0,1.0,0,0,125,44,0.0,0.0,,0.0,-1.0,0.008064516129032251,0.0,127,2,0,3,1,124,44
2020-06-23,canarias,Canarias,John Hopkins University,2415,162,0,179,1,0,0,0,-12.0,13.0,1,716,1537,944,0.00041425020712515526,0.0,,0.0,-0.016483516483516536,0.00853018372703418,0.0010604453870626251,2414,162,0,179,728,1524,943
2020-06-23,baleares,Baleares,John Hopkins University,2188,224,0,169,1,0,0,1,-9.0,10.0,2,431,1533,1144,0.0004572473708275293,0.0,,0.005952380952380931,-0.020454545454545503,0.006565988181221227,0.0017513134851139256,2187,224,0,168,440,1523,1142
2020-06-23,murcia,Murcia,John Hopkins University,1653,147,0,112,0,0,0,0,-96.0,96.0,1,-674,2180,680,0.0,0.0,,0.0,,0.04606525911708248,0.0014727540500736325,1653,147,0,112,-578,2084,679
2020-06-23,cataluna,Cataluña,John Hopkins University,60754,5666,0,2969,40,0,0,0,9.0,31.0,0,28885,26203,29497,0.0006588266297724577,0.0,,0.0,0.0003116775176617015,0.0011844719547609017,0.0,60714,5666,0,2969,28876,26172,29497
2020-06-23,c_valenciana,C. Valenciana,John Hopkins University,11494,1431,0,730,8,0,0,3,-55.0,63.0,5,93,9970,5747,0.0006965000870624571,0.0,,0.004126547455295837,-0.3716216216216216,0.00635914000201887,0.0008707767328457461,11486,1431,0,727,148,9907,5742
2020-06-23,asturias,Asturias,John Hopkins University,2435,333,0,121,0,0,0,0,-2.0,2.0,0,1039,1063,1089,0.0,0.0,,0.0,-0.0019212295869356355,0.0018850141376061114,0.0,2435,333,0,121,1041,1061,1089
2020-06-23,galicia,Galicia,John Hopkins University,9175,619,0,334,1,0,0,0,-48.0,49.0,4,-648,9204,2943,0.00010900370612598742,0.0,,0.0,,0.005352266521026827,0.0013610071452874184,9174,619,0,334,-600,9155,2939
2020-06-23,madrid,Madrid,John Hopkins University,71359,8416,0,3617,111,0,0,7,73.0,38.0,75,22207,40736,42497,0.0015579384684483166,0.0,,0.0019390581717451116,0.003298093430920801,0.0009337068160597539,0.0017679505916741167,71248,8416,0,3610,22134,40698,42422
2020-06-23,andalucia,Andalucía,John Hopkins University,12895,1426,0,766,3,0,0,2,-57.0,60.0,14,798,10671,6210,0.00023270245113238275,0.0,,0.002617801047120505,-0.06666666666666665,0.005654509471303415,0.002259522272433756,12892,1426,0,764,855,10611,6196
2020-06-23,castilla_y_leon,Castilla y León,John Hopkins University,19527,2779,0,561,11,1,0,6,10.0,,1,8032,8716,8735,0.0005636400901825045,0.00035997120230391033,,0.0108108108108107,0.001246571927200124,,0.00011449507671179582,19516,2778,0,555,8022,8716,8734
2020-06-23,ceuta,Ceuta,John Hopkins University,163,4,0,4,0,0,0,0,,,0,-4,163,11,0.0,0.0,,0.0,,,0.0,163,4,0,4,-4,163,11
2020-06-23,aragon,Aragón,John Hopkins University,6011,911,0,256,47,0,0,1,2.0,45.0,8,1328,3772,2442,0.007880617035546544,0.0,,0.0039215686274509665,0.0015082956259426794,0.012074054199087803,0.0032867707477404196,5964,911,0,255,1326,3727,2434
2020-06-23,pais_vasco,País Vasco,John Hopkins University,13727,1555,0,578,12,0,0,0,-120.0,132.0,8,-3988,16160,7032,0.0008749544294568423,0.0,,0.0,,0.00823558772148747,0.001138952164009055,13715,1555,0,578,-3868,16028,7024
2020-06-23,la_rioja,La Rioja,John Hopkins University,4073,365,0,91,0,0,0,0,-59.0,59.0,5,601,3107,1504,0.0,0.0,,0.0,-0.08939393939393936,0.019356955380577467,0.0033355570380253496,4073,365,0,91,660,3048,1499
2020-06-23,extremadura,Extremadura,John Hopkins University,3011,519,0,110,1,0,0,0,-15.0,16.0,0,-160,2652,1780,0.00033222591362136455,0.0,,0.0,,0.006069802731411222,0.0,3010,519,0,110,-145,2636,1780
2020-06-23,cantabria,Cantabria,John Hopkins University,2344,216,0,79,0,0,0,0,-14.0,14.0,0,-159,2287,1036,0.0,0.0,,0.0,,0.006159260888693341,0.0,2344,216,0,79,-145,2273,1036
2020-06-24,castilla-la_mancha,Castilla-La Mancha,John Hopkins University,17987,3022,0,639,0,0,0,0,-14,14.0,16,8573,6392,9138,0.0,0.0,,0.0,-0.001630371491789906,0.002195045468798895,0.0017540013155010747,17987,3022,0,639,8587,6378,9122
2020-06-24,navarra,Navarra,John Hopkins University,5426,528,0,136,11,0,0,0,-143,154.0,0,993,3905,2048,0.0020313942751615244,0.0,,0.0,-0.12588028169014087,0.04105571847507328,0.0,5415,528,0,136,1136,3751,2048
2020-06-24,melilla,Melilla,John Hopkins University,126,2,0,3,0,0,0,0,-1,1.0,0,-1,125,44,0.0,0.0,,0.0,,0.008064516129032251,0.0,126,2,0,3,0,124,44
2020-06-24,canarias,Canarias,John Hopkins University,2421,162,0,179,6,0,0,0,-7,13.0,1,722,1537,944,0.00248447204968949,0.0,,0.0,-0.009602194787380003,0.00853018372703418,0.0010604453870626251,2415,162,0,179,729,1524,943
2020-06-24,baleares,Baleares,John Hopkins University,2189,224,0,169,1,0,0,1,-9,10.0,2,432,1533,1144,0.0004570383912247955,0.0,,0.005952380952380931,-0.020408163265306145,0.006565988181221227,0.0017513134851139256,2188,224,0,168,441,1523,1142
2020-06-24,murcia,Murcia,John Hopkins University,1655,147,0,112,2,0,0,0,-94,96.0,1,-672,2180,680,0.001209921355111998,0.0,,0.0,,0.04606525911708248,0.0014727540500736325,1653,147,0,112,-578,2084,679
2020-06-24,cataluna,Cataluña,John Hopkins University,60847,5666,0,2969,93,0,0,0,62,31.0,0,28978,26203,29497,0.0015307634065246933,0.0,,0.0,0.002144141651680753,0.0011844719547609017,0.0,60754,5666,0,2969,28916,26172,29497
2020-06-24,c_valenciana,C. Valenciana,John Hopkins University,11501,1432,0,730,7,1,0,3,-57,63.0,5,99,9970,5747,0.0006090133982947776,0.0006988120195667857,,0.004126547455295837,-0.3653846153846154,0.00635914000201887,0.0008707767328457461,11494,1431,0,727,156,9907,5742
2020-06-24,asturias,Asturias,John Hopkins University,2435,333,0,121,0,0,0,0,-2,2.0,0,1039,1063,1089,0.0,0.0,,0.0,-0.0019212295869356355,0.0018850141376061114,0.0,2435,333,0,121,1041,1061,1089
2020-06-24,galicia,Galicia,John Hopkins University,9178,619,0,334,3,0,0,0,-46,49.0,4,-645,9204,2943,0.00032697547683913086,0.0,,0.0,,0.005352266521026827,0.0013610071452874184,9175,619,0,334,-599,9155,2939
2020-06-24,madrid,Madrid,John Hopkins University,71434,8416,0,3617,75,0,0,7,37,38.0,75,22282,40736,42497,0.0010510236970808773,0.0,,0.0019390581717451116,0.0016632951224995196,0.0009337068160597539,0.0017679505916741167,71359,8416,0,3610,22245,40698,42422
2020-06-24,andalucia,Andalucía,John Hopkins University,12917,1426,0,766,22,0,0,2,-38,60.0,14,820,10671,6210,0.0017060876308647721,0.0,,0.002617801047120505,-0.044289044289044344,0.005654509471303415,0.002259522272433756,12895,1426,0,764,858,10611,6196
2020-06-24,castilla_y_leon,Castilla y León,John Hopkins University,19563,2780,0,561,36,1,0,6,35,,1,8067,8716,8735,0.0018436011676141728,0.00035984166966529507,,0.0108108108108107,0.004357569721115562,,0.00011449507671179582,19527,2779,0,555,8032,8716,8734
2020-06-24,ceuta,Ceuta,John Hopkins University,164,4,0,4,1,0,0,0,1,,0,-3,163,11,0.006134969325153339,0.0,,0.0,,,0.0,163,4,0,4,-4,163,11
2020-06-24,aragon,Aragón,John Hopkins University,6060,911,0,256,49,0,0,1,4,45.0,8,1377,3772,2442,0.008151721843287385,0.0,,0.0039215686274509665,0.0029133284777858037,0.012074054199087803,0.0032867707477404196,6011,911,0,255,1373,3727,2434
2020-06-24,pais_vasco,País Vasco,John Hopkins University,13742,1555,0,578,15,0,0,0,-117,132.0,8,-3973,16160,7032,0.0010927369417934596,0.0,,0.0,,0.00823558772148747,0.001138952164009055,13727,1555,0,578,-3856,16028,7024
2020-06-24,la_rioja,La Rioja,John Hopkins University,4073,365,0,91,0,0,0,0,-59,59.0,5,601,3107,1504,0.0,0.0,,0.0,-0.08939393939393936,0.019356955380577467,0.0033355570380253496,4073,365,0,91,660,3048,1499
2020-06-24,extremadura,Extremadura,John Hopkins University,3017,519,0,110,6,0,0,0,-10,16.0,0,-154,2652,1780,0.0019926934573231136,0.0,,0.0,,0.006069802731411222,0.0,3011,519,0,110,-144,2636,1780
2020-06-24,cantabria,Cantabria,John Hopkins University,2351,216,0,79,7,0,0,0,-7,14.0,0,-152,2287,1036,0.002986348122866911,0.0,,0.0,,0.006159260888693341,0.0,2344,216,0,79,-145,2273,1036
2020-06-25,castilla-la_mancha,Castilla-La Mancha,John Hopkins University,18021,3022,0,639,34,0,0,0,20.0,14.0,16,8607,6392,9138,0.0018902540723855221,0.0,,0.0,0.0023291021311284688,0.002195045468798895,0.0017540013155010747,17987,3022,0,639,8587,6378,9122
2020-06-25,navarra,Navarra,John Hopkins University,5426,528,0,136,0,0,0,0,-154.0,154.0,0,993,3905,2048,0.0,0.0,,0.0,-0.13426329555361816,0.04105571847507328,0.0,5426,528,0,136,1147,3751,2048
2020-06-25,melilla,Melilla,John Hopkins University,126,2,0,3,0,0,0,0,-1.0,1.0,0,-1,125,44,0.0,0.0,,0.0,,0.008064516129032251,0.0,126,2,0,3,0,124,44
2020-06-25,canarias,Canarias,John Hopkins University,2423,162,0,179,2,0,0,0,-11.0,13.0,1,724,1537,944,0.0008261049153241995,0.0,,0.0,-0.014965986394557818,0.00853018372703418,0.0010604453870626251,2421,162,0,179,735,1524,943
2020-06-25,baleares,Baleares,John Hopkins University,2191,224,0,169,2,0,0,1,-8.0,10.0,2,434,1533,1144,0.000913659205116435,0.0,,0.005952380952380931,-0.018099547511312264,0.006565988181221227,0.0017513134851139256,2189,224,0,168,442,1523,1142
2020-06-25,murcia,Murcia,John Hopkins University,1657,147,0,112,2,0,0,0,-94.0,96.0,1,-670,2180,680,0.0012084592145014117,0.0,,0.0,,0.04606525911708248,0.0014727540500736325,1655,147,0,112,-576,2084,679
2020-06-25,cataluna,Cataluña,John Hopkins University,60927,5666,0,2969,80,0,0,0,49.0,31.0,0,29058,26203,29497,0.001314773119463597,0.0,,0.0,0.00168913095935741,0.0011844719547609017,0.0,60847,5666,0,2969,29009,26172,29497
2020-06-25,c_valenciana,C. Valenciana,John Hopkins University,11509,1432,0,730,8,0,0,3,-55.0,63.0,5,107,9970,5747,0.0006955916876794088,0.0,,0.004126547455295837,-0.3395061728395061,0.00635914000201887,0.0008707767328457461,11501,1432,0,727,162,9907,5742
2020-06-25,asturias,Asturias,John Hopkins University,2435,334,0,121,0,1,0,0,-3.0,2.0,0,1038,1063,1089,0.0,0.0030030030030030463,,0.0,-0.0028818443804035088,0.0018850141376061114,0.0,2435,333,0,121,1041,1061,1089
2020-06-25,galicia,Galicia,John Hopkins University,9186,619,0,334,8,0,0,0,-41.0,49.0,4,-637,9204,2943,0.0008716495968621452,0.0,,0.0,,0.005352266521026827,0.0013610071452874184,9178,619,0,334,-596,9155,2939
2020-06-25,madrid,Madrid,John Hopkins University,71579,8417,0,3617,145,1,0,7,106.0,38.0,75,22426,40736,42497,0.002029845731724489,0.00011882129277562825,,0.0019390581717451116,0.004749103942652377,0.0009337068160597539,0.0017679505916741167,71434,8416,0,3610,22320,40698,42422
2020-06-25,andalucia,Andalucía,John Hopkins University,12957,1426,0,766,40,0,0,2,-20.0,60.0,14,860,10671,6210,0.0030966942788572815,0.0,,0.002617801047120505,-0.022727272727272707,0.005654509471303415,0.002259522272433756,12917,1426,0,764,880,10611,6196
2020-06-25,castilla_y_leon,Castilla y León,John Hopkins University,19585,2783,0,561,22,3,0,6,19.0,,1,8086,8716,8735,0.0011245718959260742,0.0010791366906475197,,0.0108108108108107,0.0023552745754307214,,0.00011449507671179582,19563,2780,0,555,8067,8716,8734
2020-06-25,ceuta,Ceuta,John Hopkins University,164,4,0,4,0,0,0,0,,,0,-3,163,11,0.0,0.0,,0.0,,,0.0,164,4,0,4,-3,163,11
2020-06-25,aragon,Aragón,John Hopkins University,6112,911,0,256,52,0,0,1,7.0,45.0,8,1429,3772,2442,0.008580858085808662,0.0,,0.0039215686274509665,0.004922644163150469,0.012074054199087803,0.0032867707477404196,6060,911,0,255,1422,3727,2434
2020-06-25,pais_vasco,País Vasco,John Hopkins University,13745,1555,0,578,3,0,0,0,-129.0,132.0,8,-3970,16160,7032,0.00021830883423090697,0.0,,0.0,,0.00823558772148747,0.001138952164009055,13742,1555,0,578,-3841,16028,7024
2020-06-25,la_rioja,La Rioja,John Hopkins University,4074,365,0,91,1,0,0,0,-58.0,59.0,5,602,3107,1504,0.00024551927326288414,0.0,,0.0,-0.08787878787878789,0.019356955380577467,0.0033355570380253496,4073,365,0,91,660,3048,1499
2020-06-25,extremadura,Extremadura,John Hopkins University,3019,519,0,110,2,0,0,0,-14.0,16.0,0,-152,2652,1780,0.0006629101756712164,0.0,,0.0,,0.006069802731411222,0.0,3017,519,0,110,-138,2636,1780
2020-06-25,cantabria,Cantabria,John Hopkins University,2351,216,0,79,0,0,0,0,-14.0,14.0,0,-152,2287,1036,0.0,0.0,,0.0,,0.006159260888693341,0.0,2351,216,0,79,-138,2273,1036
2020-06-26,castilla-la_mancha,Castilla-La Mancha,John Hopkins University,18024,3024,0,639,3,4,0,0,-15.0,14.0,16,8608,6392,9138,0.00016647244880974021,0.0013245033112583293,,0.0,-0.0017395338049402964,0.002195045468798895,0.0017540013155010747,18021,3020,0,639,8623,6378,9122
2020-06-26,navarra,Navarra,John Hopkins University,5442,528,0,136,16,0,0,0,-138.0,154.0,0,1009,3905,2048,0.002948765204570547,0.0,,0.0,-0.12031386224934615,0.04105571847507328,0.0,5426,528,0,136,1147,3751,2048
2020-06-26,melilla,Melilla,John Hopkins University,126,2,0,3,0,0,0,0,-1.0,1.0,0,-1,125,44,0.0,0.0,,0.0,,0.008064516129032251,0.0,126,2,0,3,0,124,44
2020-06-26,canarias,Canarias,John Hopkins University,2426,162,0,179,3,0,0,0,-10.0,13.0,1,727,1537,944,0.0012381345439538283,0.0,,0.0,-0.013568521031207648,0.00853018372703418,0.0010604453870626251,2423,162,0,179,737,1524,943
2020-06-26,baleares,Baleares,John Hopkins University,2194,224,0,169,3,0,0,1,-7.0,10.0,2,437,1533,1144,0.001369237790963096,0.0,,0.005952380952380931,-0.015765765765765716,0.006565988181221227,0.0017513134851139256,2191,224,0,168,444,1523,1142
2020-06-26,murcia,Murcia,John Hopkins University,1658,147,0,112,1,0,0,0,-95.0,96.0,1,-669,2180,680,0.0006035003017501595,0.0,,0.0,,0.04606525911708248,0.0014727540500736325,1657,147,0,112,-574,2084,679
2020-06-26,cataluna,Cataluña,John Hopkins University,61073,5668,0,2969,146,2,0,0,113.0,31.0,0,29202,26203,29497,0.0023963103386019924,0.0003529827038475375,,0.0,0.0038846299288390895,0.0011844719547609017,0.0,60927,5666,0,2969,29089,26172,29497
2020-06-26,c_valenciana,C. Valenciana,John Hopkins University,11512,1432,0,730,3,0,0,3,-60.0,63.0,5,110,9970,5747,0.0002606655660786217,0.0,,0.004126547455295837,-0.3529411764705882,0.00635914000201887,0.0008707767328457461,11509,1432,0,727,170,9907,5742
2020-06-26,asturias,Asturias,John Hopkins University,2435,334,0,121,0,0,0,0,-2.0,2.0,0,1038,1063,1089,0.0,0.0,,0.0,-0.0019230769230769162,0.0018850141376061114,0.0,2435,334,0,121,1040,1061,1089
2020-06-26,galicia,Galicia,John Hopkins University,9193,619,0,334,7,0,0,0,-42.0,49.0,4,-630,9204,2943,0.000762029174831369,0.0,,0.0,,0.005352266521026827,0.0013610071452874184,9186,619,0,334,-588,9155,2939
2020-06-26,madrid,Madrid,John Hopkins University,71632,8418,0,3617,53,1,0,7,14.0,38.0,75,22478,40736,42497,0.0007404406320290491,0.00011880717595347257,,0.0019390581717451116,0.000623219373219408,0.0009337068160597539,0.0017679505916741167,71579,8417,0,3610,22464,40698,42422
2020-06-26,andalucia,Andalucía,John Hopkins University,12984,1426,0,766,27,0,0,2,-33.0,60.0,14,887,10671,6210,0.0020838156980782507,0.0,,0.002617801047120505,-0.035869565217391264,0.005654509471303415,0.002259522272433756,12957,1426,0,764,920,10611,6196
2020-06-26,castilla_y_leon,Castilla y León,John Hopkins University,19607,2783,0,561,22,0,0,6,22.0,,1,8108,8716,8735,0.0011233086545825444,0.0,,0.0108108108108107,0.0027207519168934713,,0.00011449507671179582,19585,2783,0,555,8086,8716,8734
2020-06-26,ceuta,Ceuta,John Hopkins University,163,4,0,4,0,0,0,0,,,0,-4,163,11,0.0,0.0,,0.0,,,0.0,163,4,0,4,-4,163,11
2020-06-26,aragon,Aragón,John Hopkins University,6228,912,0,256,116,1,0,1,70.0,45.0,8,1544,3772,2442,0.018979057591623105,0.001097694840834329,,0.0039215686274509665,0.04748982360922649,0.012074054199087803,0.0032867707477404196,6112,911,0,255,1474,3727,2434
2020-06-26,pais_vasco,País Vasco,John Hopkins University,13756,1555,0,578,11,0,0,0,-121.0,132.0,8,-3959,16160,7032,0.0008002910149145226,0.0,,0.0,,0.00823558772148747,0.001138952164009055,13745,1555,0,578,-3838,16028,7024
2020-06-26,la_rioja,La Rioja,John Hopkins University,4076,365,0,91,2,0,0,0,-57.0,59.0,5,604,3107,1504,0.0004909180166912108,0.0,,0.0,-0.086232980332829,0.019356955380577467,0.0033355570380253496,4074,365,0,91,661,3048,1499
2020-06-26,extremadura,Extremadura,John Hopkins University,3025,519,0,110,6,0,0,0,-10.0,16.0,0,-146,2652,1780,0.0019874130506789545,0.0,,0.0,,0.006069802731411222,0.0,3019,519,0,110,-136,2636,1780
2020-06-26,cantabria,Cantabria,John Hopkins University,2351,216,0,79,0,0,0,0,-14.0,14.0,0,-152,2287,1036,0.0,0.0,,0.0,,0.006159260888693341,0.0,2351,216,0,79,-138,2273,1036
2020-06-27,castilla-la_mancha,Castilla-La Mancha,John Hopkins University,18076,3024,0,639,52,0,0,0,38.0,14.0,16,8660,6392,9138,0.0028850421660009395,0.0,,0.0,0.004407330085826944,0.002195045468798895,0.0017540013155010747,18024,3024,0,639,8622,6378,9122
2020-06-27,navarra,Navarra,John Hopkins University,5450,528,0,136,8,0,0,0,-146.0,154.0,0,1017,3905,2048,0.0014700477765527964,0.0,,0.0,-0.12553740326741192,0.04105571847507328,0.0,5442,528,0,136,1163,3751,2048
2020-06-27,melilla,Melilla,John Hopkins University,126,2,0,3,0,0,0,0,-1.0,1.0,0,-1,125,44,0.0,0.0,,0.0,,0.008064516129032251,0.0,126,2,0,3,0,124,44
2020-06-27,canarias,Canarias,John Hopkins University,2427,162,0,179,1,0,0,0,-12.0,13.0,1,728,1537,944,0.00041220115416318315,0.0,,0.0,-0.01621621621621616,0.00853018372703418,0.0010604453870626251,2426,162,0,179,740,1524,943
2020-06-27,baleares,Baleares,John Hopkins University,2201,224,0,169,7,0,0,1,-3.0,10.0,2,444,1533,1144,0.0031905195989061497,0.0,,0.005952380952380931,-0.006711409395973145,0.006565988181221227,0.0017513134851139256,2194,224,0,168,447,1523,1142
2020-06-27,murcia,Murcia,John Hopkins University,1658,147,0,112,0,0,0,0,-96.0,96.0,1,-669,2180,680,0.0,0.0,,0.0,,0.04606525911708248,0.0014727540500736325,1658,147,0,112,-573,2084,679
2020-06-27,cataluna,Cataluña,John Hopkins University,61229,5668,0,2969,156,0,0,0,125.0,31.0,0,29358,26203,29497,0.002554320239713137,0.0,,0.0,0.0042759894639619045,0.0011844719547609017,0.0,61073,5668,0,2969,29233,26172,29497
2020-06-27,c_valenciana,C. Valenciana,John Hopkins University,11531,1432,0,730,19,0,0,3,-44.0,63.0,5,129,9970,5747,0.0016504517025712762,0.0,,0.004126547455295837,-0.2543352601156069,0.00635914000201887,0.0008707767328457461,11512,1432,0,727,173,9907,5742
2020-06-27,asturias,Asturias,John Hopkins University,2435,334,0,121,0,0,0,0,-2.0,2.0,0,1038,1063,1089,0.0,0.0,,0.0,-0.0019230769230769162,0.0018850141376061114,0.0,2435,334,0,121,1040,1061,1089
2020-06-27,galicia,Galicia,John Hopkins University,9199,619,0,334,6,0,0,0,-43.0,49.0,4,-624,9204,2943,0.0006526705101708163,0.0,,0.0,,0.005352266521026827,0.0013610071452874184,9193,619,0,334,-581,9155,2939
2020-06-27,madrid,Madrid,John Hopkins University,71839,8420,0,3617,207,2,0,7,167.0,38.0,75,22683,40736,42497,0.0028897699352243844,0.00023758612497037923,,0.0019390581717451116,0.007416947948125863,0.0009337068160597539,0.0017679505916741167,71632,8418,0,3610,22516,40698,42422
2020-06-27,andalucia,Andalucía,John Hopkins University,13027,1426,0,766,43,0,0,2,-17.0,60.0,14,930,10671,6210,0.0033117683302525958,0.0,,0.002617801047120505,-0.017951425554382228,0.005654509471303415,0.002259522272433756,12984,1426,0,764,947,10611,6196
2020-06-27,castilla_y_leon,Castilla y León,John Hopkins University,19634,2783,0,561,27,0,0,6,27.0,,1,8135,8716,8735,0.00137705921354625,0.0,,0.0108108108108107,0.003330044400591925,,0.00011449507671179582,19607,2783,0,555,8108,8716,8734
2020-06-27,ceuta,Ceuta,John Hopkins University,163,4,0,4,0,0,0,0,,,0,-4,163,11,0.0,0.0,,0.0,,,0.0,163,4,0,4,-4,163,11
2020-06-27,aragon,Aragón,John Hopkins University,6255,912,0,256,27,0,0,1,-18.0,45.0,8,1571,3772,2442,0.004335260115607031,0.0,,0.0039215686274509665,-0.011327879169288901,0.012074054199087803,0.0032867707477404196,6228,912,0,255,1589,3727,2434
2020-06-27,pais_vasco,País Vasco,John Hopkins University,13766,1555,0,578,10,0,0,0,-122.0,132.0,8,-3949,16160,7032,0.0007269555103228686,0.0,,0.0,,0.00823558772148747,0.001138952164009055,13756,1555,0,578,-3827,16028,7024
2020-06-27,la_rioja,La Rioja,John Hopkins University,4076,366,0,91,0,1,0,0,-60.0,59.0,5,603,3107,1504,0.0,0.00273972602739736,,0.0,-0.0904977375565611,0.019356955380577467,0.0033355570380253496,4076,365,0,91,663,3048,1499
2020-06-27,extremadura,Extremadura,John Hopkins University,3026,519,0,110,1,0,0,0,-15.0,16.0,0,-145,2652,1780,0.0003305785123965954,0.0,,0.0,,0.006069802731411222,0.0,3025,519,0,110,-130,2636,1780
2020-06-27,cantabria,Cantabria,John Hopkins University,2351,216,0,79,0,0,0,0,-14.0,14.0,0,-152,2287,1036,0.0,0.0,,0.0,,0.006159260888693341,0.0,2351,216,0,79,-138,2273,1036
2020-06-28,castilla-la_mancha,Castilla-La Mancha,John Hopkins University,18094,3024,0,639,18,0,0,0,4.0,14.0,16,8678,6392,9138,0.0009957955299844112,0.0,,0.0,0.0004611482591652116,0.002195045468798895,0.0017540013155010747,18076,3024,0,639,8674,6378,9122
2020-06-28,navarra,Navarra,John Hopkins University,5459,528,0,136,9,0,0,0,-145.0,154.0,0,1026,3905,2048,0.0016513761467888965,0.0,,0.0,-0.12382578992314264,0.04105571847507328,0.0,5450,528,0,136,1171,3751,2048
2020-06-28,melilla,Melilla,John Hopkins University,126,2,0,3,0,0,0,0,-1.0,1.0,0,-1,125,44,0.0,0.0,,0.0,,0.008064516129032251,0.0,126,2,0,3,0,124,44
2020-06-28,canarias,Canarias,John Hopkins University,2427,162,0,179,0,0,0,0,-13.0,13.0,1,728,1537,944,0.0,0.0,,0.0,-0.01754385964912286,0.00853018372703418,0.0010604453870626251,2427,162,0,179,741,1524,943
2020-06-28,baleares,Baleares,John Hopkins University,2205,224,0,169,4,0,0,1,-6.0,10.0,2,448,1533,1144,0.0018173557473875057,0.0,,0.005952380952380931,-0.013215859030836996,0.006565988181221227,0.0017513134851139256,2201,224,0,168,454,1523,1142
2020-06-28,murcia,Murcia,John Hopkins University,1672,147,0,112,14,0,0,0,-82.0,96.0,1,-655,2180,680,0.008443908323281013,0.0,,0.0,,0.04606525911708248,0.0014727540500736325,1658,147,0,112,-573,2084,679
2020-06-28,cataluna,Cataluña,John Hopkins University,61355,5669,0,2969,126,1,0,0,94.0,31.0,0,29483,26203,29497,0.0020578484051674284,0.00017642907551174147,,0.0,0.0031984756201299813,0.0011844719547609017,0.0,61229,5668,0,2969,29389,26172,29497
2020-06-28,c_valenciana,C. Valenciana,John Hopkins University,11537,1432,0,730,6,0,0,3,-57.0,63.0,5,135,9970,5747,0.0005203364842598646,0.0,,0.004126547455295837,-0.296875,0.00635914000201887,0.0008707767328457461,11531,1432,0,727,192,9907,5742
2020-06-28,asturias,Asturias,John Hopkins University,2435,334,0,121,0,0,0,0,-2.0,2.0,0,1038,1063,1089,0.0,0.0,,0.0,-0.0019230769230769162,0.0018850141376061114,0.0,2435,334,0,121,1040,1061,1089
2020-06-28,galicia,Galicia,John Hopkins University,9202,619,0,334,3,0,0,0,-46.0,49.0,4,-621,9204,2943,0.00032612240460916375,0.0,,0.0,,0.005352266521026827,0.0013610071452874184,9199,619,0,334,-575,9155,2939
2020-06-28,madrid,Madrid,John Hopkins University,71881,8421,0,3617,42,1,0,7,3.0,38.0,75,22724,40736,42497,0.0005846406547975747,0.00011876484560580103,,0.0019390581717451116,0.00013203644205805887,0.0009337068160597539,0.0017679505916741167,71839,8420,0,3610,22721,40698,42422
2020-06-28,andalucia,Andalucía,John Hopkins University,13045,1426,0,766,18,0,0,2,-42.0,60.0,14,948,10671,6210,0.0013817456052813704,0.0,,0.002617801047120505,-0.042424242424242475,0.005654509471303415,0.002259522272433756,13027,1426,0,764,990,10611,6196
2020-06-28,castilla_y_leon,Castilla y León,John Hopkins University,19634,2783,0,561,0,0,0,6,,,1,8135,8716,8735,0.0,0.0,,0.0108108108108107,,,0.00011449507671179582,19634,2783,0,555,8135,8716,8734
2020-06-28,ceuta,Ceuta,John Hopkins University,163,4,0,4,0,0,0,0,,,0,-4,163,11,0.0,0.0,,0.0,,,0.0,163,4,0,4,-4,163,11
2020-06-28,aragon,Aragón,John Hopkins University,6304,912,0,256,49,0,0,1,4.0,45.0,8,1620,3772,2442,0.00783373301358914,0.0,,0.0039215686274509665,0.0024752475247524774,0.012074054199087803,0.0032867707477404196,6255,912,0,255,1616,3727,2434
2020-06-28,pais_vasco,País Vasco,John Hopkins University,13767,1555,0,578,1,0,0,0,-131.0,132.0,8,-3948,16160,7032,7.26427429900145e-05,0.0,,0.0,,0.00823558772148747,0.001138952164009055,13766,1555,0,578,-3817,16028,7024
2020-06-28,la_rioja,La Rioja,John Hopkins University,4076,366,0,91,0,0,0,0,-59.0,59.0,5,603,3107,1504,0.0,0.0,,0.0,-0.08912386706948638,0.019356955380577467,0.0033355570380253496,4076,366,0,91,662,3048,1499
2020-06-28,extremadura,Extremadura,John Hopkins University,3026,519,0,110,0,0,0,0,-16.0,16.0,0,-145,2652,1780,0.0,0.0,,0.0,,0.006069802731411222,0.0,3026,519,0,110,-129,2636,1780
2020-06-28,cantabria,Cantabria,John Hopkins University,2362,216,0,79,11,0,0,0,-3.0,14.0,0,-141,2287,1036,0.004678860059549095,0.0,,0.0,,0.006159260888693341,0.0,2351,216,0,79,-138,2273,1036
2020-06-29,castilla-la_mancha,Castilla-La Mancha,John Hopkins University,18120,3025,0,639,26,1,0,0,11.0,14.0,16,8703,6392,9138,0.0014369404222394078,0.00033068783068790353,,0.0,0.0012655315232397157,0.002195045468798895,0.0017540013155010747,18094,3024,0,639,8692,6378,9122
2020-06-29,navarra,Navarra,John Hopkins University,5463,528,0,136,4,0,0,0,-150.0,154.0,0,1030,3905,2048,0.0007327349331378574,0.0,,0.0,-0.1271186440677966,0.04105571847507328,0.0,5459,528,0,136,1180,3751,2048
2020-06-29,melilla,Melilla,John Hopkins University,126,2,0,3,0,0,0,0,-1.0,1.0,0,-1,125,44,0.0,0.0,,0.0,,0.008064516129032251,0.0,126,2,0,3,0,124,44
2020-06-29,canarias,Canarias,John Hopkins University,2427,162,0,179,0,0,0,0,-13.0,13.0,1,728,1537,944,0.0,0.0,,0.0,-0.01754385964912286,0.00853018372703418,0.0010604453870626251,2427,162,0,179,741,1524,943
2020-06-29,baleares,Baleares,John Hopkins University,2206,224,0,169,1,0,0,1,-9.0,10.0,2,449,1533,1144,0.00045351473922905505,0.0,,0.005952380952380931,-0.01965065502183405,0.006565988181221227,0.0017513134851139256,2205,224,0,168,458,1523,1142
2020-06-29,murcia,Murcia,John Hopkins University,1680,147,0,112,8,0,0,0,-88.0,96.0,1,-647,2180,680,0.004784688995215225,0.0,,0.0,,0.04606525911708248,0.0014727540500736325,1672,147,0,112,-559,2084,679
2020-06-29,cataluna,Cataluña,John Hopkins University,61417,5669,0,2969,62,0,0,0,31.0,31.0,0,29545,26203,29497,0.0010105125906609835,0.0,,0.0,0.0010503489869213567,0.0011844719547609017,0.0,61355,5669,0,2969,29514,26172,29497
2020-06-29,c_valenciana,C. Valenciana,John Hopkins University,11541,1432,0,730,4,0,0,3,-59.0,63.0,5,139,9970,5747,0.00034671058334057037,0.0,,0.004126547455295837,-0.297979797979798,0.00635914000201887,0.0008707767328457461,11537,1432,0,727,198,9907,5742
2020-06-29,asturias,Asturias,John Hopkins University,2435,334,0,121,0,0,0,0,-2.0,2.0,0,1038,1063,1089,0.0,0.0,,0.0,-0.0019230769230769162,0.0018850141376061114,0.0,2435,334,0,121,1040,1061,1089
2020-06-29,galicia,Galicia,John Hopkins University,9206,619,0,334,4,0,0,0,-45.0,49.0,4,-617,9204,2943,0.00043468811128022367,0.0,,0.0,,0.005352266521026827,0.0013610071452874184,9202,619,0,334,-572,9155,2939
2020-06-29,madrid,Madrid,John Hopkins University,71885,8421,0,3617,4,0,0,7,-34.0,38.0,75,22728,40736,42497,5.564752855424793e-05,0.0,,0.0019390581717451116,-0.0014937175995080043,0.0009337068160597539,0.0017679505916741167,71881,8421,0,3610,22762,40698,42422
2020-06-29,andalucia,Andalucía,John Hopkins University,13080,1426,0,766,35,0,0,2,-25.0,60.0,14,983,10671,6210,0.00268302031429668,0.0,,0.002617801047120505,-0.024801587301587324,0.005654509471303415,0.002259522272433756,13045,1426,0,764,1008,10611,6196
2020-06-29,castilla_y_leon,Castilla y León,John Hopkins University,19665,2784,0,561,31,1,0,6,30.0,,1,8165,8716,8735,0.0015788937557299487,0.00035932446999642487,,0.0108108108108107,0.003687768899815591,,0.00011449507671179582,19634,2783,0,555,8135,8716,8734
2020-06-29,ceuta,Ceuta,John Hopkins University,163,4,0,4,0,0,0,0,,,0,-4,163,11,0.0,0.0,,0.0,,,0.0,163,4,0,4,-4,163,11
2020-06-29,aragon,Aragón,John Hopkins University,6319,912,0,256,15,0,0,1,-30.0,45.0,8,1635,3772,2442,0.0023794416243654304,0.0,,0.0039215686274509665,-0.018018018018018056,0.012074054199087803,0.0032867707477404196,6304,912,0,255,1665,3727,2434
2020-06-29,pais_vasco,País Vasco,John Hopkins University,13772,1556,0,578,5,1,0,0,-128.0,132.0,8,-3944,16160,7032,0.0003631873320257828,0.0006430868167202064,,0.0,,0.00823558772148747,0.001138952164009055,13767,1555,0,578,-3816,16028,7024
2020-06-29,la_rioja,La Rioja,John Hopkins University,4076,366,0,91,0,0,0,0,-59.0,59.0,5,603,3107,1504,0.0,0.0,,0.0,-0.08912386706948638,0.019356955380577467,0.0033355570380253496,4076,366,0,91,662,3048,1499
2020-06-29,extremadura,Extremadura,John Hopkins University,3027,519,0,110,1,0,0,0,-15.0,16.0,0,-144,2652,1780,0.00033046926635815765,0.0,,0.0,,0.006069802731411222,0.0,3026,519,0,110,-129,2636,1780
2020-06-29,cantabria,Cantabria,John Hopkins University,2362,216,0,79,0,0,0,0,-14.0,14.0,0,-141,2287,1036,0.0,0.0,,0.0,,0.006159260888693341,0.0,2362,216,0,79,-127,2273,1036
2020-06-30,castilla-la_mancha,Castilla-La Mancha,John Hopkins University,18158,3026,0,639,38,1,0,0,23.0,14.0,16,8740,6392,9138,0.002097130242825651,0.0003305785123965954,,0.0,0.0026385224274405594,0.002195045468798895,0.0017540013155010747,18120,3025,0,639,8717,6378,9122
2020-06-30,navarra,Navarra,John Hopkins University,5463,528,0,136,0,0,0,0,-154.0,154.0,0,1030,3905,2048,0.0,0.0,,0.0,-0.13006756756756754,0.04105571847507328,0.0,5463,528,0,136,1184,3751,2048
2020-06-30,melilla,Melilla,John Hopkins University,126,2,0,3,0,0,0,0,-1.0,1.0,0,-1,125,44,0.0,0.0,,0.0,,0.008064516129032251,0.0,126,2,0,3,0,124,44
2020-06-30,canarias,Canarias,John Hopkins University,2427,162,0,179,0,0,0,0,-13.0,13.0,1,728,1537,944,0.0,0.0,,0.0,-0.01754385964912286,0.00853018372703418,0.0010604453870626251,2427,162,0,179,741,1524,943
2020-06-30,baleares,Baleares,John Hopkins University,2209,224,0,169,3,0,0,1,-7.0,10.0,2,452,1533,1144,0.0013599274705349274,0.0,,0.005952380952380931,-0.015250544662309351,0.006565988181221227,0.0017513134851139256,2206,224,0,168,459,1523,1142
2020-06-30,murcia,Murcia,John Hopkins University,1684,147,0,112,4,0,0,0,-92.0,96.0,1,-643,2180,680,0.0023809523809523725,0.0,,0.0,,0.04606525911708248,0.0014727540500736325,1680,147,0,112,-551,2084,679
2020-06-30,cataluna,Cataluña,John Hopkins University,61494,5670,0,2969,77,1,0,0,45.0,31.0,0,29621,26203,29497,0.001253724538808454,0.00017639795378365797,,0.0,0.0015215039220990434,0.0011844719547609017,0.0,61417,5669,0,2969,29576,26172,29497
2020-06-30,c_valenciana,C. Valenciana,John Hopkins University,11579,1432,0,730,38,0,0,3,-25.0,63.0,5,177,9970,5747,0.003292608959362342,0.0,,0.004126547455295837,-0.12376237623762376,0.00635914000201887,0.0008707767328457461,11541,1432,0,727,202,9907,5742
2020-06-30,asturias,Asturias,John Hopkins University,2435,334,0,121,0,0,0,0,-2.0,2.0,0,1038,1063,1089,0.0,0.0,,0.0,-0.0019230769230769162,0.0018850141376061114,0.0,2435,334,0,121,1040,1061,1089
2020-06-30,galicia,Galicia,John Hopkins University,9215,619,0,334,9,0,0,0,-40.0,49.0,4,-608,9204,2943,0.0009776232891591796,0.0,,0.0,,0.005352266521026827,0.0013610071452874184,9206,619,0,334,-568,9155,2939
2020-06-30,madrid,Madrid,John Hopkins University,71950,8425,0,3617,65,4,0,7,23.0,38.0,75,22789,40736,42497,0.0009042220212840402,0.0004750029687685675,,0.0019390581717451116,0.0010102784854608693,0.0009337068160597539,0.0017679505916741167,71885,8421,0,3610,22766,40698,42422
2020-06-30,andalucia,Andalucía,John Hopkins University,13102,1427,0,766,22,1,0,2,-39.0,60.0,14,1004,10671,6210,0.0016819571865442917,0.0007012622720896644,,0.002617801047120505,-0.03739213806327901,0.005654509471303415,0.002259522272433756,13080,1426,0,764,1043,10611,6196
2020-06-30,castilla_y_leon,Castilla y León,John Hopkins University,19685,2784,0,561,20,0,0,6,20.0,,1,8185,8716,8735,0.0010170353419780565,0.0,,0.0108108108108107,0.0024494794856093627,,0.00011449507671179582,19665,2784,0,555,8165,8716,8734
2020-06-30,ceuta,Ceuta,John Hopkins University,163,4,0,4,0,0,0,0,,,0,-4,163,11,0.0,0.0,,0.0,,,0.0,163,4,0,4,-4,163,11
2020-06-30,aragon,Aragón,John Hopkins University,6330,912,0,256,11,0,0,1,-34.0,45.0,8,1646,3772,2442,0.0017407817692673966,0.0,,0.0039215686274509665,-0.020238095238095277,0.012074054199087803,0.0032867707477404196,6319,912,0,255,1680,3727,2434
2020-06-30,pais_vasco,País Vasco,John Hopkins University,13783,1558,0,578,11,2,0,0,-123.0,132.0,8,-3935,16160,7032,0.0007987220447285281,0.0012853470437017567,,0.0,,0.00823558772148747,0.001138952164009055,13772,1556,0,578,-3812,16028,7024
2020-06-30,la_rioja,La Rioja,John Hopkins University,4076,366,0,91,0,0,0,0,-59.0,59.0,5,603,3107,1504,0.0,0.0,,0.0,-0.08912386706948638,0.019356955380577467,0.0033355570380253496,4076,366,0,91,662,3048,1499
2020-06-30,extremadura,Extremadura,John Hopkins University,3030,519,0,110,3,0,0,0,-13.0,16.0,0,-141,2652,1780,0.0009910802775023875,0.0,,0.0,,0.006069802731411222,0.0,3027,519,0,110,-128,2636,1780
2020-06-30,cantabria,Cantabria,John Hopkins University,2362,216,0,79,0,0,0,0,-14.0,14.0,0,-141,2287,1036,0.0,0.0,,0.0,,0.006159260888693341,0.0,2362,216,0,79,-127,2273,1036
2020-07-01,castilla-la_mancha,Castilla-La Mancha,John Hopkins University,18160,3026,0,639,2,0,0,0,-12.0,14.0,16,8742,6392,9138,0.00011014428901856554,0.0,,0.0,-0.001370801919122644,0.002195045468798895,0.0017540013155010747,18158,3026,0,639,8754,6378,9122
2020-07-01,navarra,Navarra,John Hopkins University,5468,528,0,136,5,0,0,0,-149.0,154.0,0,1035,3905,2048,0.0009152480322167644,0.0,,0.0,-0.12584459459459463,0.04105571847507328,0.0,5463,528,0,136,1184,3751,2048
2020-07-01,melilla,Melilla,John Hopkins University,126,2,0,3,0,0,0,0,-1.0,1.0,0,-1,125,44,0.0,0.0,,0.0,,0.008064516129032251,0.0,126,2,0,3,0,124,44
2020-07-01,canarias,Canarias,John Hopkins University,2432,162,0,179,5,0,0,0,-8.0,13.0,1,733,1537,944,0.0020601565718993964,0.0,,0.0,-0.010796221322537103,0.00853018372703418,0.0010604453870626251,2427,162,0,179,741,1524,943
2020-07-01,baleares,Baleares,John Hopkins University,2216,224,0,169,7,0,0,1,-3.0,10.0,2,459,1533,1144,0.0031688546853780863,0.0,,0.005952380952380931,-0.00649350649350644,0.006565988181221227,0.0017513134851139256,2209,224,0,168,462,1523,1142
2020-07-01,murcia,Murcia,John Hopkins University,1690,147,0,112,6,0,0,0,-90.0,96.0,1,-637,2180,680,0.0035629453681709222,0.0,,0.0,,0.04606525911708248,0.0014727540500736325,1684,147,0,112,-547,2084,679
2020-07-01,cataluna,Cataluña,John Hopkins University,61639,5671,0,2969,145,1,0,0,113.0,31.0,0,29765,26203,29497,0.002357953621491493,0.00017636684303345973,,0.0,0.003810872791042863,0.0011844719547609017,0.0,61494,5670,0,2969,29652,26172,29497
2020-07-01,c_valenciana,C. Valenciana,John Hopkins University,11588,1432,0,730,9,0,0,3,-54.0,63.0,5,186,9970,5747,0.000777269194230934,0.0,,0.004126547455295837,-0.22499999999999998,0.00635914000201887,0.0008707767328457461,11579,1432,0,727,240,9907,5742
2020-07-01,asturias,Asturias,John Hopkins University,2435,334,0,121,0,0,0,0,-2.0,2.0,0,1038,1063,1089,0.0,0.0,,0.0,-0.0019230769230769162,0.0018850141376061114,0.0,2435,334,0,121,1040,1061,1089
2020-07-01,galicia,Galicia,John Hopkins University,9222,619,0,334,7,0,0,0,-42.0,49.0,4,-601,9204,2943,0.0007596310363537917,0.0,,0.0,,0.005352266521026827,0.0013610071452874184,9215,619,0,334,-559,9155,2939
2020-07-01,madrid,Madrid,John Hopkins University,72033,8427,0,3617,83,2,0,7,43.0,38.0,75,22870,40736,42497,0.0011535788742182973,0.0002373887240356698,,0.0019390581717451116,0.0018837341744426528,0.0009337068160597539,0.0017679505916741167,71950,8425,0,3610,22827,40698,42422
2020-07-01,andalucia,Andalucía,John Hopkins University,13139,1428,0,766,37,1,0,2,-24.0,60.0,14,1040,10671,6210,0.002823996336437151,0.0007007708479327412,,0.002617801047120505,-0.022556390977443663,0.005654509471303415,0.002259522272433756,13102,1427,0,764,1064,10611,6196
2020-07-01,castilla_y_leon,Castilla y León,John Hopkins University,19730,2787,0,561,45,3,0,6,42.0,,1,8227,8716,8735,0.002286004572009226,0.0010775862068965747,,0.0108108108108107,0.005131337813072623,,0.00011449507671179582,19685,2784,0,555,8185,8716,8734
2020-07-01,ceuta,Ceuta,John Hopkins University,163,4,0,4,0,0,0,0,,,0,-4,163,11,0.0,0.0,,0.0,,,0.0,163,4,0,4,-4,163,11
2020-07-01,aragon,Aragón,John Hopkins University,6353,912,0,256,23,0,0,1,-22.0,45.0,8,1669,3772,2442,0.0036334913112163747,0.0,,0.0039215686274509665,-0.013010053222945017,0.012074054199087803,0.0032867707477404196,6330,912,0,255,1691,3727,2434
2020-07-01,pais_vasco,País Vasco,John Hopkins University,13792,1560,0,578,9,2,0,0,-125.0,132.0,8,-3928,16160,7032,0.0006529783066095973,0.0012836970474967568,,0.0,,0.00823558772148747,0.001138952164009055,13783,1558,0,578,-3803,16028,7024
2020-07-01,la_rioja,La Rioja,John Hopkins University,4077,366,0,91,1,0,0,0,-58.0,59.0,5,604,3107,1504,0.0002453385672227526,0.0,,0.0,-0.08761329305135956,0.019356955380577467,0.0033355570380253496,4076,366,0,91,662,3048,1499
2020-07-01,extremadura,Extremadura,John Hopkins University,3033,519,0,110,3,0,0,0,-13.0,16.0,0,-138,2652,1780,0.000990099009900991,0.0,,0.0,,0.006069802731411222,0.0,3030,519,0,110,-125,2636,1780
2020-07-01,cantabria,Cantabria,John Hopkins University,2363,216,0,79,1,0,0,0,-13.0,14.0,0,-140,2287,1036,0.00042337002540215884,0.0,,0.0,,0.006159260888693341,0.0,2362,216,0,79,-127,2273,1036
2020-07-02,castilla-la_mancha,Castilla-La Mancha,John Hopkins University,18187,3026,0,639,27,0,0,0,13.0,14.0,16,8769,6392,9138,0.001486784140969144,0.0,,0.0,0.0014846962083143733,0.002195045468798895,0.0017540013155010747,18160,3026,0,639,8756,6378,9122
2020-07-02,navarra,Navarra,John Hopkins University,5476,528,0,136,8,0,0,0,-146.0,154.0,0,1043,3905,2048,0.001463057790782818,0.0,,0.0,-0.12279226240538266,0.04105571847507328,0.0,5468,528,0,136,1189,3751,2048
2020-07-02,melilla,Melilla,John Hopkins University,126,2,0,3,0,0,0,0,-1.0,1.0,0,-1,125,44,0.0,0.0,,0.0,,0.008064516129032251,0.0,126,2,0,3,0,124,44
2020-07-02,canarias,Canarias,John Hopkins University,2432,162,0,179,0,0,0,0,-13.0,13.0,1,733,1537,944,0.0,0.0,,0.0,-0.017426273458445052,0.00853018372703418,0.0010604453870626251,2432,162,0,179,746,1524,943
2020-07-02,baleares,Baleares,John Hopkins University,2220,224,0,169,4,0,0,1,-6.0,10.0,2,463,1533,1144,0.0018050541516245744,0.0,,0.005952380952380931,-0.01279317697228144,0.006565988181221227,0.0017513134851139256,2216,224,0,168,469,1523,1142
2020-07-02,murcia,Murcia,John Hopkins University,1693,148,0,112,3,1,0,0,-94.0,96.0,1,-635,2180,680,0.0017751479289940253,0.006802721088435382,,0.0,,0.04606525911708248,0.0014727540500736325,1690,147,0,112,-541,2084,679
2020-07-02,cataluna,Cataluña,John Hopkins University,61888,5673,0,2969,249,2,0,0,216.0,31.0,0,30012,26203,29497,0.004039650221450808,0.0003526714865103031,,0.0,0.007249295207410356,0.0011844719547609017,0.0,61639,5671,0,2969,29796,26172,29497
2020-07-02,c_valenciana,C. Valenciana,John Hopkins University,11616,1432,0,730,28,0,0,3,-35.0,63.0,5,214,9970,5747,0.0024162927166033743,0.0,,0.004126547455295837,-0.1405622489959839,0.00635914000201887,0.0008707767328457461,11588,1432,0,727,249,9907,5742
2020-07-02,asturias,Asturias,John Hopkins University,2435,334,0,121,0,0,0,0,-2.0,2.0,0,1038,1063,1089,0.0,0.0,,0.0,-0.0019230769230769162,0.0018850141376061114,0.0,2435,334,0,121,1040,1061,1089
2020-07-02,galicia,Galicia,John Hopkins University,9239,619,0,334,17,0,0,0,-32.0,49.0,4,-584,9204,2943,0.0018434179136845863,0.0,,0.0,,0.005352266521026827,0.0013610071452874184,9222,619,0,334,-552,9155,2939
2020-07-02,madrid,Madrid,John Hopkins University,72096,8428,0,3617,63,1,0,7,24.0,38.0,75,22932,40736,42497,0.0008745991420597843,0.00011866619200184836,,0.0019390581717451116,0.0010476689366161196,0.0009337068160597539,0.0017679505916741167,72033,8427,0,3610,22908,40698,42422
2020-07-02,andalucia,Andalucía,John Hopkins University,13139,1428,0,766,0,0,0,2,-60.0,60.0,14,1040,10671,6210,0.0,0.0,,0.002617801047120505,-0.054545454545454564,0.005654509471303415,0.002259522272433756,13139,1428,0,764,1100,10611,6196
2020-07-02,castilla_y_leon,Castilla y León,John Hopkins University,19750,2787,0,561,20,0,0,6,20.0,,1,8247,8716,8735,0.0010136847440445074,0.0,,0.0108108108108107,0.0024310198128114635,,0.00011449507671179582,19730,2787,0,555,8227,8716,8734
2020-07-02,ceuta,Ceuta,John Hopkins University,163,4,0,4,0,0,0,0,,,0,-4,163,11,0.0,0.0,,0.0,,,0.0,163,4,0,4,-4,163,11
2020-07-02,aragon,Aragón,John Hopkins University,6380,912,0,256,27,0,0,1,-18.0,45.0,8,1696,3772,2442,0.004249960648512463,0.0,,0.0039215686274509665,-0.010501750291715295,0.012074054199087803,0.0032867707477404196,6353,912,0,255,1714,3727,2434
2020-07-02,pais_vasco,País Vasco,John Hopkins University,13798,1560,0,578,6,0,0,0,-126.0,132.0,8,-3922,16160,7032,0.0004350348027841733,0.0,,0.0,,0.00823558772148747,0.001138952164009055,13792,1560,0,578,-3796,16028,7024
2020-07-02,la_rioja,La Rioja,John Hopkins University,4078,366,0,91,1,0,0,0,-58.0,59.0,5,605,3107,1504,0.0002452783909736578,0.0,,0.0,-0.08748114630467574,0.019356955380577467,0.0033355570380253496,4077,366,0,91,663,3048,1499
2020-07-02,extremadura,Extremadura,John Hopkins University,3040,519,0,110,7,0,0,0,-9.0,16.0,0,-131,2652,1780,0.002307945928123889,0.0,,0.0,,0.006069802731411222,0.0,3033,519,0,110,-122,2636,1780
2020-07-02,cantabria,Cantabria,John Hopkins University,2364,216,0,79,1,0,0,0,-13.0,14.0,0,-139,2287,1036,0.00042319085907749354,0.0,,0.0,,0.006159260888693341,0.0,2363,216,0,79,-126,2273,1036
